TTGACCGTCAA -> TGACCGTCAAT
TGACCGTCAAT -> GACCGTCAATA
GACCGTCAATA -> ACCGTCAATAG
ACCGTCAATAG -> CCGTCAATAGC
CCGTCAATAGC -> CGTCAATAGCG
CGTCAATAGCG -> GTCAATAGCGG
GTCAATAGCGG -> TCAATAGCGGA
TCAATAGCGGA -> CAATAGCGGAC
CAATAGCGGAC -> AATAGCGGACC
AATAGCGGACC -> ATAGCGGACCA
ATAGCGGACCA -> TAGCGGACCAA
TAGCGGACCAA -> AGCGGACCAAG
AGCGGACCAAG -> GCGGACCAAGT
GCGGACCAAGT -> CGGACCAAGTC
CGGACCAAGTC -> GGACCAAGTCG
GGACCAAGTCG -> GACCAAGTCGA
GACCAAGTCGA -> ACCAAGTCGAG
ACCAAGTCGAG -> CCAAGTCGAGA
CCAAGTCGAGA -> CAAGTCGAGAT
CAAGTCGAGAT -> AAGTCGAGATC
AAGTCGAGATC -> AGTCGAGATCC
AGTCGAGATCC -> GTCGAGATCCT
GTCGAGATCCT -> TCGAGATCCTG
TCGAGATCCTG -> CGAGATCCTGT
CGAGATCCTGT -> GAGATCCTGTA
GAGATCCTGTA -> AGATCCTGTAT
AGATCCTGTAT -> GATCCTGTATC
GATCCTGTATC -> ATCCTGTATCA
ATCCTGTATCA -> TCCTGTATCAC
TCCTGTATCAC -> CCTGTATCACC
CCTGTATCACC -> CTGTATCACCC
CTGTATCACCC -> TGTATCACCCA
TGTATCACCCA -> GTATCACCCAA
GTATCACCCAA -> TATCACCCAAG
TATCACCCAAG -> ATCACCCAAGC
ATCACCCAAGC -> TCACCCAAGCG
TCACCCAAGCG -> CACCCAAGCGA
CACCCAAGCGA -> ACCCAAGCGAC
ACCCAAGCGAC -> CCCAAGCGACG
CCCAAGCGACG -> CCAAGCGACGT
CCAAGCGACGT -> CAAGCGACGTA
CAAGCGACGTA -> AAGCGACGTAA
AAGCGACGTAA -> AGCGACGTAAC
AGCGACGTAAC -> GCGACGTAACT
GCGACGTAACT -> CGACGTAACTC
CGACGTAACTC -> GACGTAACTCT
GACGTAACTCT -> ACGTAACTCTC
ACGTAACTCTC -> CGTAACTCTCC
CGTAACTCTCC -> GTAACTCTCCC
GTAACTCTCCC -> TAACTCTCCCA
TAACTCTCCCA -> AACTCTCCCAG
AACTCTCCCAG -> ACTCTCCCAGT
ACTCTCCCAGT -> CTCTCCCAGTG
CTCTCCCAGTG -> TCTCCCAGTGC
TCTCCCAGTGC -> CTCCCAGTGCT
CTCCCAGTGCT -> TCCCAGTGCTT
TCCCAGTGCTT -> CCCAGTGCTTG
CCCAGTGCTTG -> CCAGTGCTTGA
CCAGTGCTTGA -> CAGTGCTTGAC
CAGTGCTTGAC -> AGTGCTTGACA
AGTGCTTGACA -> GTGCTTGACAC
GTGCTTGACAC -> TGCTTGACACC
TGCTTGACACC -> GCTTGACACCT
GCTTGACACCT -> CTTGACACCTG
CTTGACACCTG -> TTGACACCTGA
TTGACACCTGA -> TGACACCTGAC
TGACACCTGAC -> GACACCTGACC
GACACCTGACC -> ACACCTGACCA
ACACCTGACCA -> CACCTGACCAG
CACCTGACCAG -> ACCTGACCAGT
ACCTGACCAGT -> CCTGACCAGTG
CCTGACCAGTG -> CTGACCAGTGG
CTGACCAGTGG -> TGACCAGTGGA
TGACCAGTGGA -> GACCAGTGGAA
GACCAGTGGAA -> ACCAGTGGAAG
ACCAGTGGAAG -> CCAGTGGAAGA
CCAGTGGAAGA -> CAGTGGAAGAA
CAGTGGAAGAA -> AGTGGAAGAAG
AGTGGAAGAAG -> GTGGAAGAAGT
GTGGAAGAAGT -> TGGAAGAAGTG
TGGAAGAAGTG -> GGAAGAAGTGC
GGAAGAAGTGC -> GAAGAAGTGCT
GAAGAAGTGCT -> AAGAAGTGCTC
AAGAAGTGCTC -> AGAAGTGCTCA
AGAAGTGCTCA -> GAAGTGCTCAC
GAAGTGCTCAC -> AAGTGCTCACA
AAGTGCTCACA -> AGTGCTCACAG
AGTGCTCACAG -> GTGCTCACAGA
GTGCTCACAGA -> TGCTCACAGAG
TGCTCACAGAG -> GCTCACAGAGT
GCTCACAGAGT -> CTCACAGAGTG
CTCACAGAGTG -> TCACAGAGTGT
TCACAGAGTGT -> CACAGAGTGTG
CACAGAGTGTG -> ACAGAGTGTGG
ACAGAGTGTGG -> CAGAGTGTGGA
CAGAGTGTGGA -> AGAGTGTGGAG
AGAGTGTGGAG -> GAGTGTGGAGT
GAGTGTGGAGT -> AGTGTGGAGTC
AGTGTGGAGTC -> GTGTGGAGTCC
GTGTGGAGTCC -> TGTGGAGTCCT
TGTGGAGTCCT -> GTGGAGTCCTT
GTGGAGTCCTT -> TGGAGTCCTTT
TGGAGTCCTTT -> GGAGTCCTTTA
GGAGTCCTTTA -> GAGTCCTTTAC
GAGTCCTTTAC -> AGTCCTTTACG
AGTCCTTTACG -> GTCCTTTACGG
GTCCTTTACGG -> TCCTTTACGGG
TCCTTTACGGG -> CCTTTACGGGC
CCTTTACGGGC -> CTTTACGGGCG
CTTTACGGGCG -> TTTACGGGCGA
TTTACGGGCGA -> TTACGGGCGAA
TTACGGGCGAA -> TACGGGCGAAC
TACGGGCGAAC -> ACGGGCGAACC
ACGGGCGAACC -> CGGGCGAACCC
CGGGCGAACCC -> GGGCGAACCCT
GGGCGAACCCT -> GGCGAACCCTG
GGCGAACCCTG -> GCGAACCCTGG
GCGAACCCTGG -> CGAACCCTGGC
CGAACCCTGGC -> GAACCCTGGCC
GAACCCTGGCC -> AACCCTGGCCG
AACCCTGGCCG -> ACCCTGGCCGG
ACCCTGGCCGG -> CCCTGGCCGGG
CCCTGGCCGGG -> CCTGGCCGGGG
CCTGGCCGGGG -> CTGGCCGGGGG
CTGGCCGGGGG -> TGGCCGGGGGG
TGGCCGGGGGG -> GGCCGGGGGGC
GGCCGGGGGGC -> GCCGGGGGGCA
GCCGGGGGGCA -> CCGGGGGGCAT
CCGGGGGGCAT -> CGGGGGGCATC
CGGGGGGCATC -> GGGGGGCATCC
GGGGGGCATCC -> GGGGGCATCCC
GGGGGCATCCC -> GGGGCATCCCA
GGGGCATCCCA -> GGGCATCCCAG
GGGCATCCCAG -> GGCATCCCAGT
GGCATCCCAGT -> GCATCCCAGTG
GCATCCCAGTG -> CATCCCAGTGA
CATCCCAGTGA -> ATCCCAGTGAG
ATCCCAGTGAG -> TCCCAGTGAGC
TCCCAGTGAGC -> CCCAGTGAGCC
CCCAGTGAGCC -> CCAGTGAGCCA
CCAGTGAGCCA -> CAGTGAGCCAG
CAGTGAGCCAG -> AGTGAGCCAGG
AGTGAGCCAGG -> GTGAGCCAGGA
GTGAGCCAGGA -> TGAGCCAGGAC
TGAGCCAGGAC -> GAGCCAGGACC
GAGCCAGGACC -> AGCCAGGACCG
AGCCAGGACCG -> GCCAGGACCGA
GCCAGGACCGA -> CCAGGACCGAG
CCAGGACCGAG -> CAGGACCGAGT
CAGGACCGAGT -> AGGACCGAGTT
AGGACCGAGTT -> GGACCGAGTTT
GGACCGAGTTT -> GACCGAGTTTT
GACCGAGTTTT -> ACCGAGTTTTG
ACCGAGTTTTG -> CCGAGTTTTGG
CCGAGTTTTGG -> CGAGTTTTGGA
CGAGTTTTGGA -> GAGTTTTGGAA
GAGTTTTGGAA -> AGTTTTGGAAG
AGTTTTGGAAG -> GTTTTGGAAGT
GTTTTGGAAGT -> TTTTGGAAGTC
TTTTGGAAGTC -> TTTGGAAGTCA
TTTGGAAGTCA -> TTGGAAGTCAT
TTGGAAGTCAT -> TGGAAGTCATT
TGGAAGTCATT -> GGAAGTCATTC
GGAAGTCATTC -> GAAGTCATTCA
GAAGTCATTCA -> AAGTCATTCAG
AAGTCATTCAG -> AGTCATTCAGC
AGTCATTCAGC -> GTCATTCAGCT
GTCATTCAGCT -> TCATTCAGCTC
TCATTCAGCTC -> CATTCAGCTCC
CATTCAGCTCC -> ATTCAGCTCCG
ATTCAGCTCCG -> TTCAGCTCCGC
TTCAGCTCCGC -> TCAGCTCCGCC
TCAGCTCCGCC -> CAGCTCCGCCC
CAGCTCCGCCC -> AGCTCCGCCCA
AGCTCCGCCCA -> GCTCCGCCCAT
GCTCCGCCCAT -> CTCCGCCCATC
CTCCGCCCATC -> TCCGCCCATCG
TCCGCCCATCG -> CCGCCCATCGA
CCGCCCATCGA -> CGCCCATCGAA
CGCCCATCGAA -> GCCCATCGAAA
GCCCATCGAAA -> CCCATCGAAAA
CCCATCGAAAA -> CCATCGAAAAC
CCATCGAAAAC -> CATCGAAAACG
CATCGAAAACG -> ATCGAAAACGG
ATCGAAAACGG -> TCGAAAACGGA
TCGAAAACGGA -> CGAAAACGGAG
CGAAAACGGAG -> GAAAACGGAGG
GAAAACGGAGG -> AAAACGGAGGT
AAAACGGAGGT -> AAACGGAGGTA
AAACGGAGGTA -> AACGGAGGTAA
AACGGAGGTAA -> ACGGAGGTAAA
ACGGAGGTAAA -> CGGAGGTAAAA
CGGAGGTAAAA -> GGAGGTAAAAC
GGAGGTAAAAC -> GAGGTAAAACT
GAGGTAAAACT -> AGGTAAAACTT
AGGTAAAACTT -> GGTAAAACTTG
GGTAAAACTTG -> GTAAAACTTGC
GTAAAACTTGC -> TAAAACTTGCA
TAAAACTTGCA -> AAAACTTGCAT
AAAACTTGCAT -> AAACTTGCATT
AAACTTGCATT -> AACTTGCATTT
AACTTGCATTT -> ACTTGCATTTC
ACTTGCATTTC -> CTTGCATTTCG
CTTGCATTTCG -> TTGCATTTCGG
TTGCATTTCGG -> TGCATTTCGGA
TGCATTTCGGA -> GCATTTCGGAA
GCATTTCGGAA -> CATTTCGGAAG
CATTTCGGAAG -> ATTTCGGAAGG
ATTTCGGAAGG -> TTTCGGAAGGC
TTTCGGAAGGC -> TTCGGAAGGCG
TTCGGAAGGCG -> TCGGAAGGCGA
TCGGAAGGCGA -> CGGAAGGCGAA
CGGAAGGCGAA -> GGAAGGCGAAC
GGAAGGCGAAC -> GAAGGCGAACA
GAAGGCGAACA -> AAGGCGAACAT
AAGGCGAACAT -> AGGCGAACATG
AGGCGAACATG -> GGCGAACATGG
GGCGAACATGG -> GCGAACATGGT
GCGAACATGGT -> CGAACATGGTC
CGAACATGGTC -> GAACATGGTCA
GAACATGGTCA -> AACATGGTCAT
AACATGGTCAT -> ACATGGTCATC
ACATGGTCATC -> CATGGTCATCG
CATGGTCATCG -> ATGGTCATCGT
ATGGTCATCGT -> TGGTCATCGTT
TGGTCATCGTT -> GGTCATCGTTT
GGTCATCGTTT -> GTCATCGTTTC
GTCATCGTTTC -> TCATCGTTTCT
TCATCGTTTCT -> CATCGTTTCTA
CATCGTTTCTA -> ATCGTTTCTAA
ATCGTTTCTAA -> TCGTTTCTAAC
TCGTTTCTAAC -> CGTTTCTAACC
CGTTTCTAACC -> GTTTCTAACCG
GTTTCTAACCG -> TTTCTAACCGA
TTTCTAACCGA -> TTCTAACCGAG
TTCTAACCGAG -> TCTAACCGAGG
TCTAACCGAGG -> CTAACCGAGGT
CTAACCGAGGT -> TAACCGAGGTC
TAACCGAGGTC -> AACCGAGGTCC
AACCGAGGTCC -> ACCGAGGTCCT
ACCGAGGTCCT -> CCGAGGTCCTA
CCGAGGTCCTA -> CGAGGTCCTAA
CGAGGTCCTAA -> GAGGTCCTAAA
GAGGTCCTAAA -> AGGTCCTAAAT
AGGTCCTAAAT -> GGTCCTAAATA
GGTCCTAAATA -> GTCCTAAATAA
GTCCTAAATAA -> TCCTAAATAAT
TCCTAAATAAT -> CCTAAATAATC
CCTAAATAATC -> CTAAATAATCG
CTAAATAATCG -> TAAATAATCGC
TAAATAATCGC -> AAATAATCGCG
AAATAATCGCG -> AATAATCGCGA
AATAATCGCGA -> ATAATCGCGAT
ATAATCGCGAT -> TAATCGCGATG
TAATCGCGATG -> AATCGCGATGA
AATCGCGATGA -> ATCGCGATGAG
ATCGCGATGAG -> TCGCGATGAGG
TCGCGATGAGG -> CGCGATGAGGA
CGCGATGAGGA -> GCGATGAGGAC
GCGATGAGGAC -> CGATGAGGACC
CGATGAGGACC -> GATGAGGACCA
GATGAGGACCA -> ATGAGGACCAC
ATGAGGACCAC -> TGAGGACCACC
TGAGGACCACC -> GAGGACCACCT
GAGGACCACCT -> AGGACCACCTC
AGGACCACCTC -> GGACCACCTCG
GGACCACCTCG -> GACCACCTCGC
GACCACCTCGC -> ACCACCTCGCT
ACCACCTCGCT -> CCACCTCGCTT
CCACCTCGCTT -> CACCTCGCTTA
CACCTCGCTTA -> ACCTCGCTTAC
ACCTCGCTTAC -> CCTCGCTTACC
CCTCGCTTACC -> CTCGCTTACCA
CTCGCTTACCA -> TCGCTTACCAA
TCGCTTACCAA -> CGCTTACCAAC
CGCTTACCAAC -> GCTTACCAACG
GCTTACCAACG -> CTTACCAACGT
CTTACCAACGT -> TTACCAACGTT
TTACCAACGTT -> TACCAACGTTA
TACCAACGTTA -> ACCAACGTTAG
ACCAACGTTAG -> CCAACGTTAGC
CCAACGTTAGC -> CAACGTTAGCA
CAACGTTAGCA -> AACGTTAGCAT
AACGTTAGCAT -> ACGTTAGCATA
ACGTTAGCATA -> CGTTAGCATAC
CGTTAGCATAC -> GTTAGCATACC
GTTAGCATACC -> TTAGCATACCC
TTAGCATACCC -> TAGCATACCCG
TAGCATACCCG -> AGCATACCCGG
AGCATACCCGG -> GCATACCCGGA
GCATACCCGGA -> CATACCCGGAT
CATACCCGGAT -> ATACCCGGATA
ATACCCGGATA -> TACCCGGATAC
TACCCGGATAC -> ACCCGGATACG
ACCCGGATACG -> CCCGGATACGG
CCCGGATACGG -> CCGGATACGGG
CCGGATACGGG -> CGGATACGGGT
CGGATACGGGT -> GGATACGGGTA
GGATACGGGTA -> GATACGGGTAC
GATACGGGTAC -> ATACGGGTACA
ATACGGGTACA -> TACGGGTACAG
TACGGGTACAG -> ACGGGTACAGT
ACGGGTACAGT -> CGGGTACAGTG
CGGGTACAGTG -> GGGTACAGTGC
GGGTACAGTGC -> GGTACAGTGCT
GGTACAGTGCT -> GTACAGTGCTA
GTACAGTGCTA -> TACAGTGCTAG
TACAGTGCTAG -> ACAGTGCTAGA
ACAGTGCTAGA -> CAGTGCTAGAC
CAGTGCTAGAC -> AGTGCTAGACA
AGTGCTAGACA -> GTGCTAGACAT
GTGCTAGACAT -> TGCTAGACATA
TGCTAGACATA -> GCTAGACATAA
GCTAGACATAA -> CTAGACATAAA
CTAGACATAAA -> TAGACATAAAA
TAGACATAAAA -> AGACATAAAAC
AGACATAAAAC -> GACATAAAACC
GACATAAAACC -> ACATAAAACCT
ACATAAAACCT -> CATAAAACCTG
CATAAAACCTG -> ATAAAACCTGT
ATAAAACCTGT -> TAAAACCTGTC
TAAAACCTGTC -> AAAACCTGTCC
AAAACCTGTCC -> AAACCTGTCCC
AAACCTGTCCC -> AACCTGTCCCT
AACCTGTCCCT -> ACCTGTCCCTC
ACCTGTCCCTC -> CCTGTCCCTCA
CCTGTCCCTCA -> CTGTCCCTCAG
CTGTCCCTCAG -> TGTCCCTCAGT
TGTCCCTCAGT -> GTCCCTCAGTT
GTCCCTCAGTT -> TCCCTCAGTTG
TCCCTCAGTTG -> CCCTCAGTTGC
CCCTCAGTTGC -> CCTCAGTTGCA
CCTCAGTTGCA -> CTCAGTTGCAA
CTCAGTTGCAA -> TCAGTTGCAAA
TCAGTTGCAAA -> CAGTTGCAAAA
CAGTTGCAAAA -> AGTTGCAAAAG
AGTTGCAAAAG -> GTTGCAAAAGA
GTTGCAAAAGA -> TTGCAAAAGAG
TTGCAAAAGAG -> TGCAAAAGAGT
TGCAAAAGAGT -> GCAAAAGAGTA
GCAAAAGAGTA -> CAAAAGAGTAC
CAAAAGAGTAC -> AAAAGAGTACA
AAAAGAGTACA -> AAAGAGTACAA
AAAGAGTACAA -> AAGAGTACAAC
AAGAGTACAAC -> AGAGTACAACG
AGAGTACAACG -> GAGTACAACGC
GAGTACAACGC -> AGTACAACGCG
AGTACAACGCG -> GTACAACGCGT
GTACAACGCGT -> TACAACGCGTC
TACAACGCGTC -> ACAACGCGTCT
ACAACGCGTCT -> CAACGCGTCTG
CAACGCGTCTG -> AACGCGTCTGT
AACGCGTCTGT -> ACGCGTCTGTT
ACGCGTCTGTT -> CGCGTCTGTTC
CGCGTCTGTTC -> GCGTCTGTTCG
GCGTCTGTTCG -> CGTCTGTTCGA
CGTCTGTTCGA -> GTCTGTTCGAA
GTCTGTTCGAA -> TCTGTTCGAAG
TCTGTTCGAAG -> CTGTTCGAAGA
CTGTTCGAAGA -> TGTTCGAAGAC
TGTTCGAAGAC -> GTTCGAAGACG
GTTCGAAGACG -> TTCGAAGACGT
TTCGAAGACGT -> TCGAAGACGTA
TCGAAGACGTA -> CGAAGACGTAG
CGAAGACGTAG -> GAAGACGTAGG
GAAGACGTAGG -> AAGACGTAGGC
AAGACGTAGGC -> AGACGTAGGCT
AGACGTAGGCT -> GACGTAGGCTT
GACGTAGGCTT -> ACGTAGGCTTG
ACGTAGGCTTG -> CGTAGGCTTGT
CGTAGGCTTGT -> GTAGGCTTGTC
GTAGGCTTGTC -> TAGGCTTGTCA
TAGGCTTGTCA -> AGGCTTGTCAC
AGGCTTGTCAC -> GGCTTGTCACG
GGCTTGTCACG -> GCTTGTCACGG
GCTTGTCACGG -> CTTGTCACGGA
CTTGTCACGGA -> TTGTCACGGAG
TTGTCACGGAG -> TGTCACGGAGT
TGTCACGGAGT -> GTCACGGAGTG
GTCACGGAGTG -> TCACGGAGTGT
TCACGGAGTGT -> CACGGAGTGTT
CACGGAGTGTT -> ACGGAGTGTTC
ACGGAGTGTTC -> CGGAGTGTTCT
CGGAGTGTTCT -> GGAGTGTTCTT
GGAGTGTTCTT -> GAGTGTTCTTC
GAGTGTTCTTC -> AGTGTTCTTCC
AGTGTTCTTCC -> GTGTTCTTCCC
GTGTTCTTCCC -> TGTTCTTCCCA
TGTTCTTCCCA -> GTTCTTCCCAG
GTTCTTCCCAG -> TTCTTCCCAGT
TTCTTCCCAGT -> TCTTCCCAGTA
TCTTCCCAGTA -> CTTCCCAGTAG
CTTCCCAGTAG -> TTCCCAGTAGA
TTCCCAGTAGA -> TCCCAGTAGAA
TCCCAGTAGAA -> CCCAGTAGAAA
CCCAGTAGAAA -> CCAGTAGAAAA
CCAGTAGAAAA -> CAGTAGAAAAC
CAGTAGAAAAC -> AGTAGAAAACT
AGTAGAAAACT -> GTAGAAAACTG
GTAGAAAACTG -> TAGAAAACTGA
TAGAAAACTGA -> AGAAAACTGAT
AGAAAACTGAT -> GAAAACTGATG
GAAAACTGATG -> AAAACTGATGT
AAAACTGATGT -> AAACTGATGTT
AAACTGATGTT -> AACTGATGTTA
AACTGATGTTA -> ACTGATGTTAG
ACTGATGTTAG -> CTGATGTTAGC
CTGATGTTAGC -> TGATGTTAGCC
TGATGTTAGCC -> GATGTTAGCCT
GATGTTAGCCT -> ATGTTAGCCTG
ATGTTAGCCTG -> TGTTAGCCTGG
TGTTAGCCTGG -> GTTAGCCTGGG
GTTAGCCTGGG -> TTAGCCTGGGG
TTAGCCTGGGG -> TAGCCTGGGGT
TAGCCTGGGGT -> AGCCTGGGGTA
AGCCTGGGGTA -> GCCTGGGGTAT
GCCTGGGGTAT -> CCTGGGGTATG
CCTGGGGTATG -> CTGGGGTATGG
CTGGGGTATGG -> TGGGGTATGGT
TGGGGTATGGT -> GGGGTATGGTC
GGGGTATGGTC -> GGGTATGGTCG
GGGTATGGTCG -> GGTATGGTCGA
GGTATGGTCGA -> GTATGGTCGAC
GTATGGTCGAC -> TATGGTCGACT, TATGGTCGACC
TATGGTCGACT -> ATGGTCGACTG
ATGGTCGACTG -> TGGTCGACTGC
TGGTCGACTGC -> GGTCGACTGCA
GGTCGACTGCA -> GTCGACTGCAA
GTCGACTGCAA -> TCGACTGCAAG
TCGACTGCAAG -> CGACTGCAAGT
CGACTGCAAGT -> GACTGCAAGTT
GACTGCAAGTT -> ACTGCAAGTTG
ACTGCAAGTTG -> CTGCAAGTTGT
CTGCAAGTTGT -> TGCAAGTTGTA
TGCAAGTTGTA -> GCAAGTTGTAT
GCAAGTTGTAT -> CAAGTTGTATG
CAAGTTGTATG -> AAGTTGTATGG
AAGTTGTATGG -> AGTTGTATGGT
AGTTGTATGGT -> GTTGTATGGTC
GTTGTATGGTC -> TTGTATGGTCG
TTGTATGGTCG -> TGTATGGTCGA
TGTATGGTCGA -> GTATGGTCGAC
TATGGTCGACC -> ATGGTCGACCG
ATGGTCGACCG -> TGGTCGACCGT
TGGTCGACCGT -> GGTCGACCGTA
GGTCGACCGTA -> GTCGACCGTAA
GTCGACCGTAA -> TCGACCGTAAA
TCGACCGTAAA -> CGACCGTAAAC
CGACCGTAAAC -> GACCGTAAACG
GACCGTAAACG -> ACCGTAAACGG
ACCGTAAACGG -> CCGTAAACGGC
CCGTAAACGGC -> CGTAAACGGCT
CGTAAACGGCT -> GTAAACGGCTA
GTAAACGGCTA -> TAAACGGCTAG
TAAACGGCTAG -> AAACGGCTAGT
AAACGGCTAGT -> AACGGCTAGTG
AACGGCTAGTG -> ACGGCTAGTGG
ACGGCTAGTGG -> CGGCTAGTGGC
CGGCTAGTGGC -> GGCTAGTGGCG
GGCTAGTGGCG -> GCTAGTGGCGC
GCTAGTGGCGC -> CTAGTGGCGCA
CTAGTGGCGCA -> TAGTGGCGCAA
TAGTGGCGCAA -> AGTGGCGCAAT
AGTGGCGCAAT -> GTGGCGCAATG
GTGGCGCAATG -> TGGCGCAATGT
TGGCGCAATGT -> GGCGCAATGTG
GGCGCAATGTG -> GCGCAATGTGC
GCGCAATGTGC -> CGCAATGTGCC
CGCAATGTGCC -> GCAATGTGCCT
GCAATGTGCCT -> CAATGTGCCTC
CAATGTGCCTC -> AATGTGCCTCG
AATGTGCCTCG -> ATGTGCCTCGG
ATGTGCCTCGG -> TGTGCCTCGGC
TGTGCCTCGGC -> GTGCCTCGGCG
GTGCCTCGGCG -> TGCCTCGGCGC
TGCCTCGGCGC -> GCCTCGGCGCA
GCCTCGGCGCA -> CCTCGGCGCAG
CCTCGGCGCAG -> CTCGGCGCAGG
CTCGGCGCAGG -> TCGGCGCAGGG
TCGGCGCAGGG -> CGGCGCAGGGA
CGGCGCAGGGA -> GGCGCAGGGAG
GGCGCAGGGAG -> GCGCAGGGAGG
GCGCAGGGAGG -> CGCAGGGAGGG
CGCAGGGAGGG -> GCAGGGAGGGA
GCAGGGAGGGA -> CAGGGAGGGAT
CAGGGAGGGAT -> AGGGAGGGATC
AGGGAGGGATC -> GGGAGGGATCA
GGGAGGGATCA -> GGAGGGATCAC
GGAGGGATCAC -> GAGGGATCACA
GAGGGATCACA -> AGGGATCACAA
AGGGATCACAA -> GGGATCACAAC
GGGATCACAAC -> GGATCACAACT
GGATCACAACT -> GATCACAACTG
GATCACAACTG -> ATCACAACTGC
ATCACAACTGC -> TCACAACTGCA
TCACAACTGCA -> CACAACTGCAT
CACAACTGCAT -> ACAACTGCATC
ACAACTGCATC -> CAACTGCATCT
CAACTGCATCT -> AACTGCATCTC
AACTGCATCTC -> ACTGCATCTCA
ACTGCATCTCA -> CTGCATCTCAT
CTGCATCTCAT -> TGCATCTCATG
TGCATCTCATG -> GCATCTCATGG
GCATCTCATGG -> CATCTCATGGC
CATCTCATGGC -> ATCTCATGGCT
ATCTCATGGCT -> TCTCATGGCTA
TCTCATGGCTA -> CTCATGGCTAC
CTCATGGCTAC -> TCATGGCTACA
TCATGGCTACA -> CATGGCTACAA
CATGGCTACAA -> ATGGCTACAAG
ATGGCTACAAG -> TGGCTACAAGC
TGGCTACAAGC -> GGCTACAAGCA
GGCTACAAGCA -> GCTACAAGCAC
GCTACAAGCAC -> CTACAAGCACT
CTACAAGCACT -> TACAAGCACTT
TACAAGCACTT -> ACAAGCACTTT
ACAAGCACTTT -> CAAGCACTTTT
CAAGCACTTTT -> AAGCACTTTTA
AAGCACTTTTA -> AGCACTTTTAC
AGCACTTTTAC -> GCACTTTTACA
GCACTTTTACA -> CACTTTTACAG
CACTTTTACAG -> ACTTTTACAGT
ACTTTTACAGT -> CTTTTACAGTT
CTTTTACAGTT -> TTTTACAGTTC
TTTTACAGTTC -> TTTACAGTTCC
TTTACAGTTCC -> TTACAGTTCCC
TTACAGTTCCC -> TACAGTTCCCA
TACAGTTCCCA -> ACAGTTCCCAG
ACAGTTCCCAG -> CAGTTCCCAGC
CAGTTCCCAGC -> AGTTCCCAGCT
AGTTCCCAGCT -> GTTCCCAGCTG
GTTCCCAGCTG -> TTCCCAGCTGA
TTCCCAGCTGA -> TCCCAGCTGAA
TCCCAGCTGAA -> CCCAGCTGAAT
CCCAGCTGAAT -> CCAGCTGAATC
CCAGCTGAATC -> CAGCTGAATCC
CAGCTGAATCC -> AGCTGAATCCT
AGCTGAATCCT -> GCTGAATCCTA
GCTGAATCCTA -> CTGAATCCTAG
CTGAATCCTAG -> TGAATCCTAGG
TGAATCCTAGG -> GAATCCTAGGT
GAATCCTAGGT -> AATCCTAGGTT
AATCCTAGGTT -> ATCCTAGGTTA
ATCCTAGGTTA -> TCCTAGGTTAC
TCCTAGGTTAC -> CCTAGGTTACA
CCTAGGTTACA -> CTAGGTTACAT
CTAGGTTACAT -> TAGGTTACATT
TAGGTTACATT -> AGGTTACATTC
AGGTTACATTC -> GGTTACATTCC
GGTTACATTCC -> GTTACATTCCC
GTTACATTCCC -> TTACATTCCCG
TTACATTCCCG -> TACATTCCCGG
TACATTCCCGG -> ACATTCCCGGC
ACATTCCCGGC -> CATTCCCGGCA
CATTCCCGGCA -> ATTCCCGGCAC
ATTCCCGGCAC -> TTCCCGGCACT
TTCCCGGCACT -> TCCCGGCACTG
TCCCGGCACTG -> CCCGGCACTGT
CCCGGCACTGT -> CCGGCACTGTC
CCGGCACTGTC -> CGGCACTGTCT
CGGCACTGTCT -> GGCACTGTCTC
GGCACTGTCTC -> GCACTGTCTCA
GCACTGTCTCA -> CACTGTCTCAA
CACTGTCTCAA -> ACTGTCTCAAT
ACTGTCTCAAT -> CTGTCTCAATA
CTGTCTCAATA -> TGTCTCAATAC
TGTCTCAATAC -> GTCTCAATACG
GTCTCAATACG -> TCTCAATACGG
TCTCAATACGG -> CTCAATACGGT
CTCAATACGGT -> TCAATACGGTG
TCAATACGGTG -> CAATACGGTGA
CAATACGGTGA -> AATACGGTGAA
AATACGGTGAA -> ATACGGTGAAC
ATACGGTGAAC -> TACGGTGAACC
TACGGTGAACC -> ACGGTGAACCT
ACGGTGAACCT -> CGGTGAACCTG
CGGTGAACCTG -> GGTGAACCTGA
GGTGAACCTGA -> GTGAACCTGAT
GTGAACCTGAT -> TGAACCTGATT
TGAACCTGATT -> GAACCTGATTT
GAACCTGATTT -> AACCTGATTTC
AACCTGATTTC -> ACCTGATTTCT
ACCTGATTTCT -> CCTGATTTCTG
CCTGATTTCTG -> CTGATTTCTGA
CTGATTTCTGA -> TGATTTCTGAG
TGATTTCTGAG -> GATTTCTGAGT
GATTTCTGAGT -> ATTTCTGAGTA
ATTTCTGAGTA -> TTTCTGAGTAA
TTTCTGAGTAA -> TTCTGAGTAAT
TTCTGAGTAAT -> TCTGAGTAATT
TCTGAGTAATT -> CTGAGTAATTG
CTGAGTAATTG -> TGAGTAATTGG
TGAGTAATTGG -> GAGTAATTGGC
GAGTAATTGGC -> AGTAATTGGCA
AGTAATTGGCA -> GTAATTGGCAT
GTAATTGGCAT -> TAATTGGCATA
TAATTGGCATA -> AATTGGCATAC
AATTGGCATAC -> ATTGGCATACT
ATTGGCATACT -> TTGGCATACTA
TTGGCATACTA -> TGGCATACTAA
TGGCATACTAA -> GGCATACTAAC
GGCATACTAAC -> GCATACTAACC
GCATACTAACC -> CATACTAACCT
CATACTAACCT -> ATACTAACCTA
ATACTAACCTA -> TACTAACCTAC
TACTAACCTAC -> ACTAACCTACC
ACTAACCTACC -> CTAACCTACCT
CTAACCTACCT -> TAACCTACCTC
TAACCTACCTC -> AACCTACCTCG
AACCTACCTCG -> ACCTACCTCGG
ACCTACCTCGG -> CCTACCTCGGC
CCTACCTCGGC -> CTACCTCGGCC
CTACCTCGGCC -> TACCTCGGCCA
TACCTCGGCCA -> ACCTCGGCCAG
ACCTCGGCCAG -> CCTCGGCCAGC
CCTCGGCCAGC -> CTCGGCCAGCA
CTCGGCCAGCA -> TCGGCCAGCAA
TCGGCCAGCAA -> CGGCCAGCAAA
CGGCCAGCAAA -> GGCCAGCAAAT
GGCCAGCAAAT -> GCCAGCAAATC
GCCAGCAAATC -> CCAGCAAATCG
CCAGCAAATCG -> CAGCAAATCGT
CAGCAAATCGT -> AGCAAATCGTG
AGCAAATCGTG -> GCAAATCGTGG
GCAAATCGTGG -> CAAATCGTGGC
CAAATCGTGGC -> AAATCGTGGCC
AAATCGTGGCC -> AATCGTGGCCG
AATCGTGGCCG -> ATCGTGGCCGT
ATCGTGGCCGT -> TCGTGGCCGTC
TCGTGGCCGTC -> CGTGGCCGTCA
CGTGGCCGTCA -> GTGGCCGTCAT
GTGGCCGTCAT -> TGGCCGTCATG
TGGCCGTCATG -> GGCCGTCATGT
GGCCGTCATGT -> GCCGTCATGTG
GCCGTCATGTG -> CCGTCATGTGT
CCGTCATGTGT -> CGTCATGTGTC
CGTCATGTGTC -> GTCATGTGTCG
GTCATGTGTCG -> TCATGTGTCGC
TCATGTGTCGC -> CATGTGTCGCT
CATGTGTCGCT -> ATGTGTCGCTG
ATGTGTCGCTG -> TGTGTCGCTGG
TGTGTCGCTGG -> GTGTCGCTGGA
GTGTCGCTGGA -> TGTCGCTGGAC
TGTCGCTGGAC -> GTCGCTGGACT
GTCGCTGGACT -> TCGCTGGACTG
TCGCTGGACTG -> CGCTGGACTGA
CGCTGGACTGA -> GCTGGACTGAC
GCTGGACTGAC -> CTGGACTGACG
CTGGACTGACG -> TGGACTGACGT
TGGACTGACGT -> GGACTGACGTG
GGACTGACGTG -> GACTGACGTGC
GACTGACGTGC -> ACTGACGTGCA
ACTGACGTGCA -> CTGACGTGCAA
CTGACGTGCAA -> TGACGTGCAAT
TGACGTGCAAT -> GACGTGCAATC
GACGTGCAATC -> ACGTGCAATCA
ACGTGCAATCA -> CGTGCAATCAT
CGTGCAATCAT -> GTGCAATCATG
GTGCAATCATG -> TGCAATCATGC
TGCAATCATGC -> GCAATCATGCT
GCAATCATGCT -> CAATCATGCTT
CAATCATGCTT -> AATCATGCTTC
AATCATGCTTC -> ATCATGCTTCC
ATCATGCTTCC -> TCATGCTTCCG
TCATGCTTCCG -> CATGCTTCCGG
CATGCTTCCGG -> ATGCTTCCGGG
ATGCTTCCGGG -> TGCTTCCGGGT
TGCTTCCGGGT -> GCTTCCGGGTT
GCTTCCGGGTT -> CTTCCGGGTTT
CTTCCGGGTTT -> TTCCGGGTTTT
TTCCGGGTTTT -> TCCGGGTTTTC
TCCGGGTTTTC -> CCGGGTTTTCA
CCGGGTTTTCA -> CGGGTTTTCAT
CGGGTTTTCAT -> GGGTTTTCATG
GGGTTTTCATG -> GGTTTTCATGC
GGTTTTCATGC -> GTTTTCATGCC
GTTTTCATGCC -> TTTTCATGCCG
TTTTCATGCCG -> TTTCATGCCGC
TTTCATGCCGC -> TTCATGCCGCC
TTCATGCCGCC -> TCATGCCGCCT
TCATGCCGCCT -> CATGCCGCCTT
CATGCCGCCTT -> ATGCCGCCTTA
ATGCCGCCTTA -> TGCCGCCTTAT
TGCCGCCTTAT -> GCCGCCTTATA
GCCGCCTTATA -> CCGCCTTATAA
CCGCCTTATAA -> CGCCTTATAAC
CGCCTTATAAC -> GCCTTATAACA
GCCTTATAACA -> CCTTATAACAT
CCTTATAACAT -> CTTATAACATA
CTTATAACATA -> TTATAACATAA
TTATAACATAA -> TATAACATAAG
TATAACATAAG -> ATAACATAAGG
ATAACATAAGG -> TAACATAAGGT
TAACATAAGGT -> AACATAAGGTA
AACATAAGGTA -> ACATAAGGTAT
ACATAAGGTAT -> CATAAGGTATG
CATAAGGTATG -> ATAAGGTATGA
ATAAGGTATGA -> TAAGGTATGAT
TAAGGTATGAT -> AAGGTATGATT
AAGGTATGATT -> AGGTATGATTT
AGGTATGATTT -> GGTATGATTTA
GGTATGATTTA -> GTATGATTTAT
GTATGATTTAT -> TATGATTTATC
TATGATTTATC -> ATGATTTATCA
ATGATTTATCA -> TGATTTATCAT
TGATTTATCAT -> GATTTATCATT
GATTTATCATT -> ATTTATCATTT
ATTTATCATTT -> TTTATCATTTG
TTTATCATTTG -> TTATCATTTGA
TTATCATTTGA -> TATCATTTGAA
TATCATTTGAA -> ATCATTTGAAG
ATCATTTGAAG -> TCATTTGAAGC
TCATTTGAAGC -> CATTTGAAGCT
CATTTGAAGCT -> ATTTGAAGCTC
ATTTGAAGCTC -> TTTGAAGCTCC
TTTGAAGCTCC -> TTGAAGCTCCA
TTGAAGCTCCA -> TGAAGCTCCAA
TGAAGCTCCAA -> GAAGCTCCAAG
GAAGCTCCAAG -> AAGCTCCAAGT
AAGCTCCAAGT -> AGCTCCAAGTG
AGCTCCAAGTG -> GCTCCAAGTGA
GCTCCAAGTGA -> CTCCAAGTGAC
CTCCAAGTGAC -> TCCAAGTGACA
TCCAAGTGACA -> CCAAGTGACAT
CCAAGTGACAT -> CAAGTGACATA
CAAGTGACATA -> AAGTGACATAT
AAGTGACATAT -> AGTGACATATG
AGTGACATATG -> GTGACATATGT
GTGACATATGT -> TGACATATGTC
TGACATATGTC -> GACATATGTCT
GACATATGTCT -> ACATATGTCTA
ACATATGTCTA -> CATATGTCTAT
CATATGTCTAT -> ATATGTCTATG
ATATGTCTATG -> TATGTCTATGA
TATGTCTATGA -> ATGTCTATGAC
ATGTCTATGAC -> TGTCTATGACT
TGTCTATGACT -> GTCTATGACTT
GTCTATGACTT -> TCTATGACTTT
TCTATGACTTT -> CTATGACTTTC
CTATGACTTTC -> TATGACTTTCG
TATGACTTTCG -> ATGACTTTCGG
ATGACTTTCGG -> TGACTTTCGGC
TGACTTTCGGC -> GACTTTCGGCA
GACTTTCGGCA -> ACTTTCGGCAT
ACTTTCGGCAT -> CTTTCGGCATG
CTTTCGGCATG -> TTTCGGCATGG
TTTCGGCATGG -> TTCGGCATGGG
TTCGGCATGGG -> TCGGCATGGGG
TCGGCATGGGG -> CGGCATGGGGA
CGGCATGGGGA -> GGCATGGGGAG
GGCATGGGGAG -> GCATGGGGAGT
GCATGGGGAGT -> CATGGGGAGTG
CATGGGGAGTG -> ATGGGGAGTGT
ATGGGGAGTGT -> TGGGGAGTGTT
TGGGGAGTGTT -> GGGGAGTGTTG
GGGGAGTGTTG -> GGGAGTGTTGC
GGGAGTGTTGC -> GGAGTGTTGCC
GGAGTGTTGCC -> GAGTGTTGCCC
GAGTGTTGCCC -> AGTGTTGCCCC
AGTGTTGCCCC -> GTGTTGCCCCA
GTGTTGCCCCA -> TGTTGCCCCAT
TGTTGCCCCAT -> GTTGCCCCATG
GTTGCCCCATG -> TTGCCCCATGT
TTGCCCCATGT -> TGCCCCATGTA
TGCCCCATGTA -> GCCCCATGTAG
GCCCCATGTAG -> CCCCATGTAGC
CCCCATGTAGC -> CCCATGTAGCC
CCCATGTAGCC -> CCATGTAGCCC
CCATGTAGCCC -> CATGTAGCCCG
CATGTAGCCCG -> ATGTAGCCCGG
ATGTAGCCCGG -> TGTAGCCCGGC
TGTAGCCCGGC -> GTAGCCCGGCA
GTAGCCCGGCA -> TAGCCCGGCAC
TAGCCCGGCAC -> AGCCCGGCACC
AGCCCGGCACC -> GCCCGGCACCA
GCCCGGCACCA -> CCCGGCACCAG
CCCGGCACCAG -> CCGGCACCAGT
CCGGCACCAGT -> CGGCACCAGTT
CGGCACCAGTT -> GGCACCAGTTT
GGCACCAGTTT -> GCACCAGTTTC
GCACCAGTTTC -> CACCAGTTTCG
CACCAGTTTCG -> ACCAGTTTCGG
ACCAGTTTCGG -> CCAGTTTCGGG
CCAGTTTCGGG -> CAGTTTCGGGA
CAGTTTCGGGA -> AGTTTCGGGAC
AGTTTCGGGAC -> GTTTCGGGACT
GTTTCGGGACT -> TTTCGGGACTC
TTTCGGGACTC -> TTCGGGACTCC
TTCGGGACTCC -> TCGGGACTCCG
TCGGGACTCCG -> CGGGACTCCGA
CGGGACTCCGA -> GGGACTCCGAC
GGGACTCCGAC -> GGACTCCGACA
GGACTCCGACA -> GACTCCGACAG
GACTCCGACAG -> ACTCCGACAGA
ACTCCGACAGA -> CTCCGACAGAC
CTCCGACAGAC -> TCCGACAGACC
TCCGACAGACC -> CCGACAGACCC
CCGACAGACCC -> CGACAGACCCG
CGACAGACCCG -> GACAGACCCGG
GACAGACCCGG -> ACAGACCCGGT
ACAGACCCGGT -> CAGACCCGGTG
CAGACCCGGTG -> AGACCCGGTGT
AGACCCGGTGT -> GACCCGGTGTA
GACCCGGTGTA -> ACCCGGTGTAA
ACCCGGTGTAA -> CCCGGTGTAAA
CCCGGTGTAAA -> CCGGTGTAAAG
CCGGTGTAAAG -> CGGTGTAAAGC
CGGTGTAAAGC -> GGTGTAAAGCC
GGTGTAAAGCC -> GTGTAAAGCCT
GTGTAAAGCCT -> TGTAAAGCCTG
TGTAAAGCCTG -> GTAAAGCCTGG
GTAAAGCCTGG -> TAAAGCCTGGC
TAAAGCCTGGC -> AAAGCCTGGCC
AAAGCCTGGCC -> AAGCCTGGCCG
AAGCCTGGCCG -> AGCCTGGCCGC
AGCCTGGCCGC -> GCCTGGCCGCT
GCCTGGCCGCT -> CCTGGCCGCTC
CCTGGCCGCTC -> CTGGCCGCTCC
CTGGCCGCTCC -> TGGCCGCTCCG
TGGCCGCTCCG -> GGCCGCTCCGA
GGCCGCTCCGA -> GCCGCTCCGAC
GCCGCTCCGAC -> CCGCTCCGACC
CCGCTCCGACC -> CGCTCCGACCG
CGCTCCGACCG -> GCTCCGACCGG
GCTCCGACCGG -> CTCCGACCGGC
CTCCGACCGGC -> TCCGACCGGCG
TCCGACCGGCG -> CCGACCGGCGT
CCGACCGGCGT -> CGACCGGCGTC
CGACCGGCGTC -> GACCGGCGTCC
GACCGGCGTCC -> ACCGGCGTCCC
ACCGGCGTCCC -> CCGGCGTCCCT
CCGGCGTCCCT -> CGGCGTCCCTT
CGGCGTCCCTT -> GGCGTCCCTTG
GGCGTCCCTTG -> GCGTCCCTTGA
GCGTCCCTTGA -> CGTCCCTTGAG
CGTCCCTTGAG -> GTCCCTTGAGC
GTCCCTTGAGC -> TCCCTTGAGCA
TCCCTTGAGCA -> CCCTTGAGCAT
CCCTTGAGCAT -> CCTTGAGCATG
CCTTGAGCATG -> CTTGAGCATGA
CTTGAGCATGA -> TTGAGCATGAA
TTGAGCATGAA -> TGAGCATGAAT
TGAGCATGAAT -> GAGCATGAATG
GAGCATGAATG -> AGCATGAATGT
AGCATGAATGT -> GCATGAATGTT
GCATGAATGTT -> CATGAATGTTT
CATGAATGTTT -> ATGAATGTTTC
ATGAATGTTTC -> TGAATGTTTCA
TGAATGTTTCA -> GAATGTTTCAG
GAATGTTTCAG -> AATGTTTCAGT
AATGTTTCAGT -> ATGTTTCAGTT
ATGTTTCAGTT -> TGTTTCAGTTA
TGTTTCAGTTA -> GTTTCAGTTAG
GTTTCAGTTAG -> TTTCAGTTAGG
TTTCAGTTAGG -> TTCAGTTAGGG
TTCAGTTAGGG -> TCAGTTAGGGT
TCAGTTAGGGT -> CAGTTAGGGTC
CAGTTAGGGTC -> AGTTAGGGTCT
AGTTAGGGTCT -> GTTAGGGTCTG
GTTAGGGTCTG -> TTAGGGTCTGA
TTAGGGTCTGA -> TAGGGTCTGAG
TAGGGTCTGAG -> AGGGTCTGAGC
AGGGTCTGAGC -> GGGTCTGAGCA
GGGTCTGAGCA -> GGTCTGAGCAT
GGTCTGAGCAT -> GTCTGAGCATT
GTCTGAGCATT -> TCTGAGCATTA
TCTGAGCATTA -> CTGAGCATTAG
CTGAGCATTAG -> TGAGCATTAGT
TGAGCATTAGT -> GAGCATTAGTG
GAGCATTAGTG -> AGCATTAGTGG
AGCATTAGTGG -> GCATTAGTGGA
GCATTAGTGGA -> CATTAGTGGAG
CATTAGTGGAG -> ATTAGTGGAGA
ATTAGTGGAGA -> TTAGTGGAGAC
TTAGTGGAGAC -> TAGTGGAGACG
TAGTGGAGACG -> AGTGGAGACGT
AGTGGAGACGT -> GTGGAGACGTA
GTGGAGACGTA -> TGGAGACGTAA
TGGAGACGTAA -> GGAGACGTAAG
GGAGACGTAAG -> GAGACGTAAGG
GAGACGTAAGG -> AGACGTAAGGT
AGACGTAAGGT -> GACGTAAGGTA
GACGTAAGGTA -> ACGTAAGGTAT
ACGTAAGGTAT -> CGTAAGGTATG
CGTAAGGTATG -> GTAAGGTATGG
GTAAGGTATGG -> TAAGGTATGGG
TAAGGTATGGG -> AAGGTATGGGA
AAGGTATGGGA -> AGGTATGGGAT
AGGTATGGGAT -> GGTATGGGATC
GGTATGGGATC -> GTATGGGATCC
GTATGGGATCC -> TATGGGATCCG
TATGGGATCCG -> ATGGGATCCGC
ATGGGATCCGC -> TGGGATCCGCG
TGGGATCCGCG -> GGGATCCGCGT
GGGATCCGCGT -> GGATCCGCGTG
GGATCCGCGTG -> GATCCGCGTGT
GATCCGCGTGT -> ATCCGCGTGTC
ATCCGCGTGTC -> TCCGCGTGTCC
TCCGCGTGTCC -> CCGCGTGTCCA
CCGCGTGTCCA -> CGCGTGTCCAG
CGCGTGTCCAG -> GCGTGTCCAGC
GCGTGTCCAGC -> CGTGTCCAGCA
CGTGTCCAGCA -> GTGTCCAGCAT
GTGTCCAGCAT -> TGTCCAGCATG
TGTCCAGCATG -> GTCCAGCATGA
GTCCAGCATGA -> TCCAGCATGAC
TCCAGCATGAC -> CCAGCATGACT
CCAGCATGACT -> CAGCATGACTG
CAGCATGACTG -> AGCATGACTGG
AGCATGACTGG -> GCATGACTGGA
GCATGACTGGA -> CATGACTGGAT
CATGACTGGAT -> ATGACTGGATA
ATGACTGGATA -> TGACTGGATAA
TGACTGGATAA -> GACTGGATAAG
GACTGGATAAG -> ACTGGATAAGT
ACTGGATAAGT -> CTGGATAAGTG
CTGGATAAGTG -> TGGATAAGTGT
TGGATAAGTGT -> GGATAAGTGTC
GGATAAGTGTC -> GATAAGTGTCA
GATAAGTGTCA -> ATAAGTGTCAT
ATAAGTGTCAT -> TAAGTGTCATA
TAAGTGTCATA -> AAGTGTCATAA
AAGTGTCATAA -> AGTGTCATAAG
AGTGTCATAAG -> GTGTCATAAGG
GTGTCATAAGG -> TGTCATAAGGC
TGTCATAAGGC -> GTCATAAGGCC
GTCATAAGGCC -> TCATAAGGCCA
TCATAAGGCCA -> CATAAGGCCAC
CATAAGGCCAC -> ATAAGGCCACT
ATAAGGCCACT -> TAAGGCCACTC
TAAGGCCACTC -> AAGGCCACTCA
AAGGCCACTCA -> AGGCCACTCAT
AGGCCACTCAT -> GGCCACTCATA
GGCCACTCATA -> GCCACTCATAC
GCCACTCATAC -> CCACTCATACT
CCACTCATACT -> CACTCATACTG
CACTCATACTG -> ACTCATACTGT
ACTCATACTGT -> CTCATACTGTA
CTCATACTGTA -> TCATACTGTAA
TCATACTGTAA -> CATACTGTAAA
CATACTGTAAA -> ATACTGTAAAT
ATACTGTAAAT -> TACTGTAAATC
TACTGTAAATC -> ACTGTAAATCT
ACTGTAAATCT -> CTGTAAATCTA
CTGTAAATCTA -> TGTAAATCTAT
TGTAAATCTAT -> GTAAATCTATA
GTAAATCTATA -> TAAATCTATAC
TAAATCTATAC -> AAATCTATACT
AAATCTATACT -> AATCTATACTA
AATCTATACTA -> ATCTATACTAT
ATCTATACTAT -> TCTATACTATG
TCTATACTATG -> CTATACTATGC
CTATACTATGC -> TATACTATGCT
TATACTATGCT -> ATACTATGCTC
ATACTATGCTC -> TACTATGCTCG
TACTATGCTCG -> ACTATGCTCGG
ACTATGCTCGG -> CTATGCTCGGA
CTATGCTCGGA -> TATGCTCGGAC
TATGCTCGGAC -> ATGCTCGGACT
ATGCTCGGACT -> TGCTCGGACTA
TGCTCGGACTA -> GCTCGGACTAG
GCTCGGACTAG -> CTCGGACTAGT
CTCGGACTAGT -> TCGGACTAGTT
TCGGACTAGTT -> CGGACTAGTTT
CGGACTAGTTT -> GGACTAGTTTA
GGACTAGTTTA -> GACTAGTTTAA
GACTAGTTTAA -> ACTAGTTTAAG
ACTAGTTTAAG -> CTAGTTTAAGA
CTAGTTTAAGA -> TAGTTTAAGAG
TAGTTTAAGAG -> AGTTTAAGAGA
AGTTTAAGAGA -> GTTTAAGAGAA
GTTTAAGAGAA -> TTTAAGAGAAA
TTTAAGAGAAA -> TTAAGAGAAAT
TTAAGAGAAAT -> TAAGAGAAATG
TAAGAGAAATG -> AAGAGAAATGA
AAGAGAAATGA -> AGAGAAATGAT
AGAGAAATGAT -> GAGAAATGATG
GAGAAATGATG -> AGAAATGATGT
AGAAATGATGT -> GAAATGATGTC
GAAATGATGTC -> AAATGATGTCG
AAATGATGTCG -> AATGATGTCGA
AATGATGTCGA -> ATGATGTCGAA
ATGATGTCGAA -> TGATGTCGAAT
TGATGTCGAAT -> GATGTCGAATT
GATGTCGAATT -> ATGTCGAATTC
ATGTCGAATTC -> TGTCGAATTCA
TGTCGAATTCA -> GTCGAATTCAG
GTCGAATTCAG -> TCGAATTCAGC
TCGAATTCAGC -> CGAATTCAGCC
CGAATTCAGCC -> GAATTCAGCCC
GAATTCAGCCC -> AATTCAGCCCT
AATTCAGCCCT -> ATTCAGCCCTC
ATTCAGCCCTC -> TTCAGCCCTCC
TTCAGCCCTCC -> TCAGCCCTCCG
TCAGCCCTCCG -> CAGCCCTCCGC
CAGCCCTCCGC -> AGCCCTCCGCA
AGCCCTCCGCA -> GCCCTCCGCAC
GCCCTCCGCAC -> CCCTCCGCACT
CCCTCCGCACT -> CCTCCGCACTG
CCTCCGCACTG -> CTCCGCACTGA
CTCCGCACTGA -> TCCGCACTGAC
TCCGCACTGAC -> CCGCACTGACT
CCGCACTGACT -> CGCACTGACTC
CGCACTGACTC -> GCACTGACTCG
GCACTGACTCG -> CACTGACTCGA
CACTGACTCGA -> ACTGACTCGAC
ACTGACTCGAC -> CTGACTCGACA
CTGACTCGACA -> TGACTCGACAA
TGACTCGACAA -> GACTCGACAAG
GACTCGACAAG -> ACTCGACAAGT
ACTCGACAAGT -> CTCGACAAGTT
CTCGACAAGTT -> TCGACAAGTTG
TCGACAAGTTG -> CGACAAGTTGT
CGACAAGTTGT -> GACAAGTTGTG
GACAAGTTGTG -> ACAAGTTGTGC
ACAAGTTGTGC -> CAAGTTGTGCT
CAAGTTGTGCT -> AAGTTGTGCTA
AAGTTGTGCTA -> AGTTGTGCTAG
AGTTGTGCTAG -> GTTGTGCTAGC
GTTGTGCTAGC -> TTGTGCTAGCG
TTGTGCTAGCG -> TGTGCTAGCGG
TGTGCTAGCGG -> GTGCTAGCGGG
GTGCTAGCGGG -> TGCTAGCGGGC
TGCTAGCGGGC -> GCTAGCGGGCG
GCTAGCGGGCG -> CTAGCGGGCGA
CTAGCGGGCGA -> TAGCGGGCGAG
TAGCGGGCGAG -> AGCGGGCGAGA
AGCGGGCGAGA -> GCGGGCGAGAC
GCGGGCGAGAC -> CGGGCGAGACC
CGGGCGAGACC -> GGGCGAGACCC
GGGCGAGACCC -> GGCGAGACCCA
GGCGAGACCCA -> GCGAGACCCAG
GCGAGACCCAG -> CGAGACCCAGG
CGAGACCCAGG -> GAGACCCAGGT
GAGACCCAGGT -> AGACCCAGGTA
AGACCCAGGTA -> GACCCAGGTAC
GACCCAGGTAC -> ACCCAGGTACC
ACCCAGGTACC -> CCCAGGTACCT
CCCAGGTACCT -> CCAGGTACCTG
CCAGGTACCTG -> CAGGTACCTGT
CAGGTACCTGT -> AGGTACCTGTG
AGGTACCTGTG -> GGTACCTGTGA
GGTACCTGTGA -> GTACCTGTGAA
GTACCTGTGAA -> TACCTGTGAAG
TACCTGTGAAG -> ACCTGTGAAGT
ACCTGTGAAGT -> CCTGTGAAGTA
CCTGTGAAGTA -> CTGTGAAGTAG
CTGTGAAGTAG -> TGTGAAGTAGT
TGTGAAGTAGT -> GTGAAGTAGTG
GTGAAGTAGTG -> TGAAGTAGTGG
TGAAGTAGTGG -> GAAGTAGTGGC
GAAGTAGTGGC -> AAGTAGTGGCG
AAGTAGTGGCG -> AGTAGTGGCGG
AGTAGTGGCGG -> GTAGTGGCGGA
GTAGTGGCGGA -> TAGTGGCGGAG
TAGTGGCGGAG -> AGTGGCGGAGC
AGTGGCGGAGC -> GTGGCGGAGCG
GTGGCGGAGCG -> TGGCGGAGCGC
TGGCGGAGCGC -> GGCGGAGCGCA
GGCGGAGCGCA -> GCGGAGCGCAG
GCGGAGCGCAG -> CGGAGCGCAGT
CGGAGCGCAGT -> GGAGCGCAGTC
GGAGCGCAGTC -> GAGCGCAGTCA
GAGCGCAGTCA -> AGCGCAGTCAC
AGCGCAGTCAC -> GCGCAGTCACA
GCGCAGTCACA -> CGCAGTCACAC
CGCAGTCACAC -> GCAGTCACACC
GCAGTCACACC -> CAGTCACACCG
CAGTCACACCG -> AGTCACACCGG
AGTCACACCGG -> GTCACACCGGG
GTCACACCGGG -> TCACACCGGGA
TCACACCGGGA -> CACACCGGGAC
CACACCGGGAC -> ACACCGGGACG
ACACCGGGACG -> CACCGGGACGC
CACCGGGACGC -> ACCGGGACGCC
ACCGGGACGCC -> CCGGGACGCCT
CCGGGACGCCT -> CGGGACGCCTG
CGGGACGCCTG -> GGGACGCCTGT
GGGACGCCTGT -> GGACGCCTGTG
GGACGCCTGTG -> GACGCCTGTGA
GACGCCTGTGA -> ACGCCTGTGAT
ACGCCTGTGAT -> CGCCTGTGATG
CGCCTGTGATG -> GCCTGTGATGA
GCCTGTGATGA -> CCTGTGATGAC
CCTGTGATGAC -> CTGTGATGACT
CTGTGATGACT -> TGTGATGACTT
TGTGATGACTT -> GTGATGACTTA
GTGATGACTTA -> TGATGACTTAG
TGATGACTTAG -> GATGACTTAGG
GATGACTTAGG -> ATGACTTAGGA
ATGACTTAGGA -> TGACTTAGGAA
TGACTTAGGAA -> GACTTAGGAAC
GACTTAGGAAC -> ACTTAGGAACA
ACTTAGGAACA -> CTTAGGAACAA
CTTAGGAACAA -> TTAGGAACAAG
TTAGGAACAAG -> TAGGAACAAGT
TAGGAACAAGT -> AGGAACAAGTT
AGGAACAAGTT -> GGAACAAGTTC
GGAACAAGTTC -> GAACAAGTTCT
GAACAAGTTCT -> AACAAGTTCTG
AACAAGTTCTG -> ACAAGTTCTGC
ACAAGTTCTGC -> CAAGTTCTGCA
CAAGTTCTGCA -> AAGTTCTGCAA
AAGTTCTGCAA -> AGTTCTGCAAT
AGTTCTGCAAT -> GTTCTGCAATA
GTTCTGCAATA -> TTCTGCAATAG
TTCTGCAATAG -> TCTGCAATAGG
TCTGCAATAGG -> CTGCAATAGGG
CTGCAATAGGG -> TGCAATAGGGG
TGCAATAGGGG -> GCAATAGGGGC
GCAATAGGGGC -> CAATAGGGGCT
CAATAGGGGCT -> AATAGGGGCTA
AATAGGGGCTA -> ATAGGGGCTAG
ATAGGGGCTAG -> TAGGGGCTAGA
TAGGGGCTAGA -> AGGGGCTAGAA
AGGGGCTAGAA -> GGGGCTAGAAC
GGGGCTAGAAC -> GGGCTAGAACT
GGGCTAGAACT -> GGCTAGAACTA
GGCTAGAACTA -> GCTAGAACTAC
GCTAGAACTAC -> CTAGAACTACT
CTAGAACTACT -> TAGAACTACTA
TAGAACTACTA -> AGAACTACTAG
AGAACTACTAG -> GAACTACTAGC
GAACTACTAGC -> AACTACTAGCA
AACTACTAGCA -> ACTACTAGCAA
ACTACTAGCAA -> CTACTAGCAAG
CTACTAGCAAG -> TACTAGCAAGT
TACTAGCAAGT -> ACTAGCAAGTT
ACTAGCAAGTT -> CTAGCAAGTTC
CTAGCAAGTTC -> TAGCAAGTTCT
TAGCAAGTTCT -> AGCAAGTTCTG
AGCAAGTTCTG -> GCAAGTTCTGG
GCAAGTTCTGG -> CAAGTTCTGGT
CAAGTTCTGGT -> AAGTTCTGGTC
AAGTTCTGGTC -> AGTTCTGGTCG
AGTTCTGGTCG -> GTTCTGGTCGC
GTTCTGGTCGC -> TTCTGGTCGCG
TTCTGGTCGCG -> TCTGGTCGCGC
TCTGGTCGCGC -> CTGGTCGCGCA
CTGGTCGCGCA -> TGGTCGCGCAA
TGGTCGCGCAA -> GGTCGCGCAAT
GGTCGCGCAAT -> GTCGCGCAATA
GTCGCGCAATA -> TCGCGCAATAT
TCGCGCAATAT -> CGCGCAATATC
CGCGCAATATC -> GCGCAATATCA
GCGCAATATCA -> CGCAATATCAG
CGCAATATCAG -> GCAATATCAGG
GCAATATCAGG -> CAATATCAGGG
CAATATCAGGG -> AATATCAGGGA
AATATCAGGGA -> ATATCAGGGAC
ATATCAGGGAC -> TATCAGGGACC
TATCAGGGACC -> ATCAGGGACCG
ATCAGGGACCG -> TCAGGGACCGT
TCAGGGACCGT -> CAGGGACCGTC
CAGGGACCGTC -> AGGGACCGTCG
AGGGACCGTCG -> GGGACCGTCGG
GGGACCGTCGG -> GGACCGTCGGG
GGACCGTCGGG -> GACCGTCGGGT
GACCGTCGGGT -> ACCGTCGGGTT
ACCGTCGGGTT -> CCGTCGGGTTG
CCGTCGGGTTG -> CGTCGGGTTGC
CGTCGGGTTGC -> GTCGGGTTGCG
GTCGGGTTGCG -> TCGGGTTGCGC
TCGGGTTGCGC -> CGGGTTGCGCA
CGGGTTGCGCA -> GGGTTGCGCAA
GGGTTGCGCAA -> GGTTGCGCAAC
GGTTGCGCAAC -> GTTGCGCAACA
GTTGCGCAACA -> TTGCGCAACAG
TTGCGCAACAG -> TGCGCAACAGC
TGCGCAACAGC -> GCGCAACAGCC
GCGCAACAGCC -> CGCAACAGCCA
CGCAACAGCCA -> GCAACAGCCAG
GCAACAGCCAG -> CAACAGCCAGG
CAACAGCCAGG -> AACAGCCAGGT
AACAGCCAGGT -> ACAGCCAGGTT
ACAGCCAGGTT -> CAGCCAGGTTT
CAGCCAGGTTT -> AGCCAGGTTTC
AGCCAGGTTTC -> GCCAGGTTTCT
GCCAGGTTTCT -> CCAGGTTTCTG
CCAGGTTTCTG -> CAGGTTTCTGT
CAGGTTTCTGT -> AGGTTTCTGTA
AGGTTTCTGTA -> GGTTTCTGTAT
GGTTTCTGTAT -> GTTTCTGTATT
GTTTCTGTATT -> TTTCTGTATTG
TTTCTGTATTG -> TTCTGTATTGG
TTCTGTATTGG -> TCTGTATTGGG
TCTGTATTGGG -> CTGTATTGGGG
CTGTATTGGGG -> TGTATTGGGGT
TGTATTGGGGT -> GTATTGGGGTG
GTATTGGGGTG -> TATTGGGGTGG
TATTGGGGTGG -> ATTGGGGTGGA
ATTGGGGTGGA -> TTGGGGTGGAC
TTGGGGTGGAC -> TGGGGTGGACA
TGGGGTGGACA -> GGGGTGGACAA
GGGGTGGACAA -> GGGTGGACAAC
GGGTGGACAAC -> GGTGGACAACT
GGTGGACAACT -> GTGGACAACTT
GTGGACAACTT -> TGGACAACTTA
TGGACAACTTA -> GGACAACTTAT
GGACAACTTAT -> GACAACTTATT
GACAACTTATT -> ACAACTTATTG
ACAACTTATTG -> CAACTTATTGC
CAACTTATTGC -> AACTTATTGCC
AACTTATTGCC -> ACTTATTGCCA
ACTTATTGCCA -> CTTATTGCCAG
CTTATTGCCAG -> TTATTGCCAGA
TTATTGCCAGA -> TATTGCCAGAG
TATTGCCAGAG -> ATTGCCAGAGG
ATTGCCAGAGG -> TTGCCAGAGGG
TTGCCAGAGGG -> TGCCAGAGGGG
TGCCAGAGGGG -> GCCAGAGGGGC
GCCAGAGGGGC -> CCAGAGGGGCC
CCAGAGGGGCC -> CAGAGGGGCCA
CAGAGGGGCCA -> AGAGGGGCCAA
AGAGGGGCCAA -> GAGGGGCCAAG
GAGGGGCCAAG -> AGGGGCCAAGC
AGGGGCCAAGC -> GGGGCCAAGCC
GGGGCCAAGCC -> GGGCCAAGCCT
GGGCCAAGCCT -> GGCCAAGCCTA
GGCCAAGCCTA -> GCCAAGCCTAA
GCCAAGCCTAA -> CCAAGCCTAAT
CCAAGCCTAAT -> CAAGCCTAATG
CAAGCCTAATG -> AAGCCTAATGT
AAGCCTAATGT -> AGCCTAATGTC
AGCCTAATGTC -> GCCTAATGTCT
GCCTAATGTCT -> CCTAATGTCTA
CCTAATGTCTA -> CTAATGTCTAC
CTAATGTCTAC -> TAATGTCTACC
TAATGTCTACC -> AATGTCTACCA
AATGTCTACCA -> ATGTCTACCAA
ATGTCTACCAA -> TGTCTACCAAC
TGTCTACCAAC -> GTCTACCAACC
GTCTACCAACC -> TCTACCAACCA
TCTACCAACCA -> CTACCAACCAT
CTACCAACCAT -> TACCAACCATT
TACCAACCATT -> ACCAACCATTC
ACCAACCATTC -> CCAACCATTCT
CCAACCATTCT -> CAACCATTCTT
CAACCATTCTT -> AACCATTCTTT
AACCATTCTTT -> ACCATTCTTTA
ACCATTCTTTA -> CCATTCTTTAG
CCATTCTTTAG -> CATTCTTTAGG
CATTCTTTAGG -> ATTCTTTAGGG
ATTCTTTAGGG -> TTCTTTAGGGC
TTCTTTAGGGC -> TCTTTAGGGCT
TCTTTAGGGCT -> CTTTAGGGCTA
CTTTAGGGCTA -> TTTAGGGCTAA
TTTAGGGCTAA -> TTAGGGCTAAT
TTAGGGCTAAT -> TAGGGCTAATT
TAGGGCTAATT -> AGGGCTAATTC
AGGGCTAATTC -> GGGCTAATTCT
GGGCTAATTCT -> GGCTAATTCTA
GGCTAATTCTA -> GCTAATTCTAT
GCTAATTCTAT -> CTAATTCTATG
CTAATTCTATG -> TAATTCTATGG
TAATTCTATGG -> AATTCTATGGT
AATTCTATGGT -> ATTCTATGGTA
ATTCTATGGTA -> TTCTATGGTAA
TTCTATGGTAA -> TCTATGGTAAT
TCTATGGTAAT -> CTATGGTAATT
CTATGGTAATT -> TATGGTAATTC
TATGGTAATTC -> ATGGTAATTCC
ATGGTAATTCC -> TGGTAATTCCA
TGGTAATTCCA -> GGTAATTCCAG
GGTAATTCCAG -> GTAATTCCAGG
GTAATTCCAGG -> TAATTCCAGGG
TAATTCCAGGG -> AATTCCAGGGG
AATTCCAGGGG -> ATTCCAGGGGG
ATTCCAGGGGG -> TTCCAGGGGGA
TTCCAGGGGGA -> TCCAGGGGGAA
TCCAGGGGGAA -> CCAGGGGGAAG
CCAGGGGGAAG -> CAGGGGGAAGT
CAGGGGGAAGT -> AGGGGGAAGTA
AGGGGGAAGTA -> GGGGGAAGTAC
GGGGGAAGTAC -> GGGGAAGTACG
GGGGAAGTACG -> GGGAAGTACGA
GGGAAGTACGA -> GGAAGTACGAT
GGAAGTACGAT -> GAAGTACGATC
GAAGTACGATC -> AAGTACGATCT
AAGTACGATCT -> AGTACGATCTG
AGTACGATCTG -> GTACGATCTGA
GTACGATCTGA -> TACGATCTGAT
TACGATCTGAT -> ACGATCTGATC
ACGATCTGATC -> CGATCTGATCC
CGATCTGATCC -> GATCTGATCCA
GATCTGATCCA -> ATCTGATCCAA
ATCTGATCCAA -> TCTGATCCAAA
TCTGATCCAAA -> CTGATCCAAAG
CTGATCCAAAG -> TGATCCAAAGT
TGATCCAAAGT -> GATCCAAAGTA
GATCCAAAGTA -> ATCCAAAGTAC
ATCCAAAGTAC -> TCCAAAGTACT
TCCAAAGTACT -> CCAAAGTACTT
CCAAAGTACTT -> CAAAGTACTTC
CAAAGTACTTC -> AAAGTACTTCA
AAAGTACTTCA -> AAGTACTTCAG
AAGTACTTCAG -> AGTACTTCAGA
AGTACTTCAGA -> GTACTTCAGAG
GTACTTCAGAG -> TACTTCAGAGG
TACTTCAGAGG -> ACTTCAGAGGC
ACTTCAGAGGC -> CTTCAGAGGCT
CTTCAGAGGCT -> TTCAGAGGCTT
TTCAGAGGCTT -> TCAGAGGCTTG
TCAGAGGCTTG -> CAGAGGCTTGC
CAGAGGCTTGC -> AGAGGCTTGCT
AGAGGCTTGCT -> GAGGCTTGCTG
GAGGCTTGCTG -> AGGCTTGCTGC
AGGCTTGCTGC -> GGCTTGCTGCG
GGCTTGCTGCG -> GCTTGCTGCGC
GCTTGCTGCGC -> CTTGCTGCGCT
CTTGCTGCGCT -> TTGCTGCGCTA
TTGCTGCGCTA -> TGCTGCGCTAT
TGCTGCGCTAT -> GCTGCGCTATG
GCTGCGCTATG -> CTGCGCTATGT
CTGCGCTATGT -> TGCGCTATGTG
TGCGCTATGTG -> GCGCTATGTGT
GCGCTATGTGT -> CGCTATGTGTT
CGCTATGTGTT -> GCTATGTGTTT
GCTATGTGTTT -> CTATGTGTTTT
CTATGTGTTTT -> TATGTGTTTTC
TATGTGTTTTC -> ATGTGTTTTCG
ATGTGTTTTCG -> TGTGTTTTCGT
TGTGTTTTCGT -> GTGTTTTCGTT
GTGTTTTCGTT -> TGTTTTCGTTT
TGTTTTCGTTT -> GTTTTCGTTTT
GTTTTCGTTTT -> TTTTCGTTTTT
TTTTCGTTTTT -> TTTCGTTTTTT
TTTCGTTTTTT -> TTCGTTTTTTC
TTCGTTTTTTC -> TCGTTTTTTCT
TCGTTTTTTCT -> CGTTTTTTCTC
CGTTTTTTCTC -> GTTTTTTCTCC
GTTTTTTCTCC -> TTTTTTCTCCG
TTTTTTCTCCG -> TTTTTCTCCGC
TTTTTCTCCGC -> TTTTCTCCGCC
TTTTCTCCGCC -> TTTCTCCGCCT
TTTCTCCGCCT -> TTCTCCGCCTG
TTCTCCGCCTG -> TCTCCGCCTGG
TCTCCGCCTGG -> CTCCGCCTGGA
CTCCGCCTGGA -> TCCGCCTGGAT
TCCGCCTGGAT -> CCGCCTGGATA
CCGCCTGGATA -> CGCCTGGATAT
CGCCTGGATAT -> GCCTGGATATA
GCCTGGATATA -> CCTGGATATAT
CCTGGATATAT -> CTGGATATATG
CTGGATATATG -> TGGATATATGT
TGGATATATGT -> GGATATATGTC
GGATATATGTC -> GATATATGTCC
GATATATGTCC -> ATATATGTCCG
ATATATGTCCG -> TATATGTCCGG
TATATGTCCGG -> ATATGTCCGGA
ATATGTCCGGA -> TATGTCCGGAA
TATGTCCGGAA -> ATGTCCGGAAT
ATGTCCGGAAT -> TGTCCGGAATA
TGTCCGGAATA -> GTCCGGAATAT
GTCCGGAATAT -> TCCGGAATATT
TCCGGAATATT -> CCGGAATATTG
CCGGAATATTG -> CGGAATATTGC
CGGAATATTGC -> GGAATATTGCG
GGAATATTGCG -> GAATATTGCGT
GAATATTGCGT -> AATATTGCGTG
AATATTGCGTG -> ATATTGCGTGC
ATATTGCGTGC -> TATTGCGTGCG
TATTGCGTGCG -> ATTGCGTGCGT
ATTGCGTGCGT -> TTGCGTGCGTT
TTGCGTGCGTT -> TGCGTGCGTTA
TGCGTGCGTTA -> GCGTGCGTTAT
GCGTGCGTTAT -> CGTGCGTTATA
CGTGCGTTATA -> GTGCGTTATAC
GTGCGTTATAC -> TGCGTTATACA
TGCGTTATACA -> GCGTTATACAG
GCGTTATACAG -> CGTTATACAGC
CGTTATACAGC -> GTTATACAGCC
GTTATACAGCC -> TTATACAGCCA
TTATACAGCCA -> TATACAGCCAG
TATACAGCCAG -> ATACAGCCAGC
ATACAGCCAGC -> TACAGCCAGCA
TACAGCCAGCA -> ACAGCCAGCAG
ACAGCCAGCAG -> CAGCCAGCAGT
CAGCCAGCAGT -> AGCCAGCAGTA
AGCCAGCAGTA -> GCCAGCAGTAT
GCCAGCAGTAT -> CCAGCAGTATG
CCAGCAGTATG -> CAGCAGTATGG
CAGCAGTATGG -> AGCAGTATGGC
AGCAGTATGGC -> GCAGTATGGCC
GCAGTATGGCC -> CAGTATGGCCC
CAGTATGGCCC -> AGTATGGCCCG
AGTATGGCCCG -> GTATGGCCCGA
GTATGGCCCGA -> TATGGCCCGAT
TATGGCCCGAT -> ATGGCCCGATG
ATGGCCCGATG -> TGGCCCGATGG
TGGCCCGATGG -> GGCCCGATGGG
GGCCCGATGGG -> GCCCGATGGGT
GCCCGATGGGT -> CCCGATGGGTA
CCCGATGGGTA -> CCGATGGGTAT
CCGATGGGTAT -> CGATGGGTATT
CGATGGGTATT -> GATGGGTATTG
GATGGGTATTG -> ATGGGTATTGG
ATGGGTATTGG -> TGGGTATTGGA
TGGGTATTGGA -> GGGTATTGGAG
GGGTATTGGAG -> GGTATTGGAGT
GGTATTGGAGT -> GTATTGGAGTT
GTATTGGAGTT -> TATTGGAGTTT
TATTGGAGTTT -> ATTGGAGTTTG
ATTGGAGTTTG -> TTGGAGTTTGC
TTGGAGTTTGC -> TGGAGTTTGCA
TGGAGTTTGCA -> GGAGTTTGCAA
GGAGTTTGCAA -> GAGTTTGCAAT
GAGTTTGCAAT -> AGTTTGCAATA
AGTTTGCAATA -> GTTTGCAATAC
GTTTGCAATAC -> TTTGCAATACG
TTTGCAATACG -> TTGCAATACGA
TTGCAATACGA -> TGCAATACGAT
TGCAATACGAT -> GCAATACGATA
GCAATACGATA -> CAATACGATAT
CAATACGATAT -> AATACGATATT
AATACGATATT -> ATACGATATTT
ATACGATATTT -> TACGATATTTG
TACGATATTTG -> ACGATATTTGA
ACGATATTTGA -> CGATATTTGAT
CGATATTTGAT -> GATATTTGATC
GATATTTGATC -> ATATTTGATCG
ATATTTGATCG -> TATTTGATCGG
TATTTGATCGG -> ATTTGATCGGG
ATTTGATCGGG -> TTTGATCGGGA
TTTGATCGGGA -> TTGATCGGGAA
TTGATCGGGAA -> TGATCGGGAAA
TGATCGGGAAA -> GATCGGGAAAA
GATCGGGAAAA -> ATCGGGAAAAG
ATCGGGAAAAG -> TCGGGAAAAGA
TCGGGAAAAGA -> CGGGAAAAGAC
CGGGAAAAGAC -> GGGAAAAGACC
GGGAAAAGACC -> GGAAAAGACCC
GGAAAAGACCC -> GAAAAGACCCG
GAAAAGACCCG -> AAAAGACCCGA
AAAAGACCCGA -> AAAGACCCGAT
AAAGACCCGAT -> AAGACCCGATA
AAGACCCGATA -> AGACCCGATAG
AGACCCGATAG -> GACCCGATAGC
GACCCGATAGC -> ACCCGATAGCT
ACCCGATAGCT -> CCCGATAGCTG
CCCGATAGCTG -> CCGATAGCTGT
CCGATAGCTGT -> CGATAGCTGTA
CGATAGCTGTA -> GATAGCTGTAG
GATAGCTGTAG -> ATAGCTGTAGT
ATAGCTGTAGT -> TAGCTGTAGTG
TAGCTGTAGTG -> AGCTGTAGTGT
AGCTGTAGTGT -> GCTGTAGTGTT
GCTGTAGTGTT -> CTGTAGTGTTG
CTGTAGTGTTG -> TGTAGTGTTGA
TGTAGTGTTGA -> GTAGTGTTGAA
GTAGTGTTGAA -> TAGTGTTGAAC
TAGTGTTGAAC -> AGTGTTGAACC
AGTGTTGAACC -> GTGTTGAACCC
GTGTTGAACCC -> TGTTGAACCCC
TGTTGAACCCC -> GTTGAACCCCG
GTTGAACCCCG -> TTGAACCCCGT
TTGAACCCCGT -> TGAACCCCGTT
TGAACCCCGTT -> GAACCCCGTTG
GAACCCCGTTG -> AACCCCGTTGA
AACCCCGTTGA -> ACCCCGTTGAG
ACCCCGTTGAG -> CCCCGTTGAGA
CCCCGTTGAGA -> CCCGTTGAGAT
CCCGTTGAGAT -> CCGTTGAGATA
CCGTTGAGATA -> CGTTGAGATAG
CGTTGAGATAG -> GTTGAGATAGC
GTTGAGATAGC -> TTGAGATAGCG
TTGAGATAGCG -> TGAGATAGCGA
TGAGATAGCGA -> GAGATAGCGAA
GAGATAGCGAA -> AGATAGCGAAC
AGATAGCGAAC -> GATAGCGAACT
GATAGCGAACT -> ATAGCGAACTC
ATAGCGAACTC -> TAGCGAACTCC
TAGCGAACTCC -> AGCGAACTCCG
AGCGAACTCCG -> GCGAACTCCGA
GCGAACTCCGA -> CGAACTCCGAC
CGAACTCCGAC -> GAACTCCGACT
GAACTCCGACT -> AACTCCGACTA
AACTCCGACTA -> ACTCCGACTAA
ACTCCGACTAA -> CTCCGACTAAC
CTCCGACTAAC -> TCCGACTAACA
TCCGACTAACA -> CCGACTAACAA
CCGACTAACAA -> CGACTAACAAC
CGACTAACAAC -> GACTAACAACA
GACTAACAACA -> ACTAACAACAA
ACTAACAACAA -> CTAACAACAAG
CTAACAACAAG -> TAACAACAAGG
TAACAACAAGG -> AACAACAAGGG
AACAACAAGGG -> ACAACAAGGGT
ACAACAAGGGT -> CAACAAGGGTA
CAACAAGGGTA -> AACAAGGGTAG
AACAAGGGTAG -> ACAAGGGTAGG
ACAAGGGTAGG -> CAAGGGTAGGC
CAAGGGTAGGC -> AAGGGTAGGCT
AAGGGTAGGCT -> AGGGTAGGCTG
AGGGTAGGCTG -> GGGTAGGCTGC
GGGTAGGCTGC -> GGTAGGCTGCA
GGTAGGCTGCA -> GTAGGCTGCAC
GTAGGCTGCAC -> TAGGCTGCACA
TAGGCTGCACA -> AGGCTGCACAG
AGGCTGCACAG -> GGCTGCACAGC
GGCTGCACAGC -> GCTGCACAGCT
GCTGCACAGCT -> CTGCACAGCTC
CTGCACAGCTC -> TGCACAGCTCA
TGCACAGCTCA -> GCACAGCTCAT
GCACAGCTCAT -> CACAGCTCATA
CACAGCTCATA -> ACAGCTCATAA
ACAGCTCATAA -> CAGCTCATAAT
CAGCTCATAAT -> AGCTCATAATA
AGCTCATAATA -> GCTCATAATAG
GCTCATAATAG -> CTCATAATAGG
CTCATAATAGG -> TCATAATAGGC
TCATAATAGGC -> CATAATAGGCG
CATAATAGGCG -> ATAATAGGCGT
ATAATAGGCGT -> TAATAGGCGTC
TAATAGGCGTC -> AATAGGCGTCG
AATAGGCGTCG -> ATAGGCGTCGA
ATAGGCGTCGA -> TAGGCGTCGAT
TAGGCGTCGAT -> AGGCGTCGATA
AGGCGTCGATA -> GGCGTCGATAA
GGCGTCGATAA -> GCGTCGATAAC
GCGTCGATAAC -> CGTCGATAACT
CGTCGATAACT -> GTCGATAACTC
GTCGATAACTC -> TCGATAACTCT
TCGATAACTCT -> CGATAACTCTC
CGATAACTCTC -> GATAACTCTCC
GATAACTCTCC -> ATAACTCTCCA
ATAACTCTCCA -> TAACTCTCCAC
TAACTCTCCAC -> AACTCTCCACC
AACTCTCCACC -> ACTCTCCACCC
ACTCTCCACCC -> CTCTCCACCCT
CTCTCCACCCT -> TCTCCACCCTT
TCTCCACCCTT -> CTCCACCCTTC
CTCCACCCTTC -> TCCACCCTTCT
TCCACCCTTCT -> CCACCCTTCTC
CCACCCTTCTC -> CACCCTTCTCG
CACCCTTCTCG -> ACCCTTCTCGA
ACCCTTCTCGA -> CCCTTCTCGAG
CCCTTCTCGAG -> CCTTCTCGAGT
CCTTCTCGAGT -> CTTCTCGAGTC
CTTCTCGAGTC -> TTCTCGAGTCC
TTCTCGAGTCC -> TCTCGAGTCCA
TCTCGAGTCCA -> CTCGAGTCCAG
CTCGAGTCCAG -> TCGAGTCCAGT
TCGAGTCCAGT -> CGAGTCCAGTA
CGAGTCCAGTA -> GAGTCCAGTAC
GAGTCCAGTAC -> AGTCCAGTACC
AGTCCAGTACC -> GTCCAGTACCG
GTCCAGTACCG -> TCCAGTACCGG
TCCAGTACCGG -> CCAGTACCGGT
CCAGTACCGGT -> CAGTACCGGTA
CAGTACCGGTA -> AGTACCGGTAC
AGTACCGGTAC -> GTACCGGTACC
GTACCGGTACC -> TACCGGTACCT
TACCGGTACCT -> ACCGGTACCTC
ACCGGTACCTC -> CCGGTACCTCC
CCGGTACCTCC -> CGGTACCTCCC
CGGTACCTCCC -> GGTACCTCCCA
GGTACCTCCCA -> GTACCTCCCAG
GTACCTCCCAG -> TACCTCCCAGT
TACCTCCCAGT -> ACCTCCCAGTG
ACCTCCCAGTG -> CCTCCCAGTGC
CCTCCCAGTGC -> CTCCCAGTGCG
CTCCCAGTGCG -> TCCCAGTGCGT
TCCCAGTGCGT -> CCCAGTGCGTC
CCCAGTGCGTC -> CCAGTGCGTCG
CCAGTGCGTCG -> CAGTGCGTCGG
CAGTGCGTCGG -> AGTGCGTCGGC
AGTGCGTCGGC -> GTGCGTCGGCT
GTGCGTCGGCT -> TGCGTCGGCTT
TGCGTCGGCTT -> GCGTCGGCTTA
GCGTCGGCTTA -> CGTCGGCTTAT
CGTCGGCTTAT -> GTCGGCTTATC
GTCGGCTTATC -> TCGGCTTATCA
TCGGCTTATCA -> CGGCTTATCAC
CGGCTTATCAC -> GGCTTATCACA
GGCTTATCACA -> GCTTATCACAA
GCTTATCACAA -> CTTATCACAAT
CTTATCACAAT -> TTATCACAATT
TTATCACAATT -> TATCACAATTG
TATCACAATTG -> ATCACAATTGG
ATCACAATTGG -> TCACAATTGGA
TCACAATTGGA -> CACAATTGGAT
CACAATTGGAT -> ACAATTGGATG
ACAATTGGATG -> CAATTGGATGA
CAATTGGATGA -> AATTGGATGAC
AATTGGATGAC -> ATTGGATGACA
ATTGGATGACA -> TTGGATGACAT
TTGGATGACAT -> TGGATGACATG
TGGATGACATG -> GGATGACATGG
GGATGACATGG -> GATGACATGGA
GATGACATGGA -> ATGACATGGAT
ATGACATGGAT -> TGACATGGATA
TGACATGGATA -> GACATGGATAG
GACATGGATAG -> ACATGGATAGT
ACATGGATAGT -> CATGGATAGTC
CATGGATAGTC -> ATGGATAGTCT
ATGGATAGTCT -> TGGATAGTCTC
TGGATAGTCTC -> GGATAGTCTCT
GGATAGTCTCT -> GATAGTCTCTC
GATAGTCTCTC -> ATAGTCTCTCG
ATAGTCTCTCG -> TAGTCTCTCGT
TAGTCTCTCGT -> AGTCTCTCGTC
AGTCTCTCGTC -> GTCTCTCGTCC
GTCTCTCGTCC -> TCTCTCGTCCT
TCTCTCGTCCT -> CTCTCGTCCTC
CTCTCGTCCTC -> TCTCGTCCTCT
TCTCGTCCTCT -> CTCGTCCTCTT
CTCGTCCTCTT -> TCGTCCTCTTG
TCGTCCTCTTG -> CGTCCTCTTGG
CGTCCTCTTGG -> GTCCTCTTGGG
GTCCTCTTGGG -> TCCTCTTGGGG
TCCTCTTGGGG -> CCTCTTGGGGC
CCTCTTGGGGC -> CTCTTGGGGCT
CTCTTGGGGCT -> TCTTGGGGCTA
TCTTGGGGCTA -> CTTGGGGCTAA
CTTGGGGCTAA -> TTGGGGCTAAC
TTGGGGCTAAC -> TGGGGCTAACG
TGGGGCTAACG -> GGGGCTAACGG
GGGGCTAACGG -> GGGCTAACGGC
GGGCTAACGGC -> GGCTAACGGCC
GGCTAACGGCC -> GCTAACGGCCG
GCTAACGGCCG -> CTAACGGCCGG
CTAACGGCCGG -> TAACGGCCGGT
TAACGGCCGGT -> AACGGCCGGTA
AACGGCCGGTA -> ACGGCCGGTAC
ACGGCCGGTAC -> CGGCCGGTACA
CGGCCGGTACA -> GGCCGGTACAC
GGCCGGTACAC -> GCCGGTACACA
GCCGGTACACA -> CCGGTACACAT
CCGGTACACAT -> CGGTACACATC
CGGTACACATC -> GGTACACATCG
GGTACACATCG -> GTACACATCGG
GTACACATCGG -> TACACATCGGA
TACACATCGGA -> ACACATCGGAC
ACACATCGGAC -> CACATCGGACG
CACATCGGACG -> ACATCGGACGG
ACATCGGACGG -> CATCGGACGGT
CATCGGACGGT -> ATCGGACGGTT
ATCGGACGGTT -> TCGGACGGTTA
TCGGACGGTTA -> CGGACGGTTAG
CGGACGGTTAG -> GGACGGTTAGA
GGACGGTTAGA -> GACGGTTAGAT
GACGGTTAGAT -> ACGGTTAGATC
ACGGTTAGATC -> CGGTTAGATCG
CGGTTAGATCG -> GGTTAGATCGG
GGTTAGATCGG -> GTTAGATCGGA
GTTAGATCGGA -> TTAGATCGGAT
TTAGATCGGAT -> TAGATCGGATC
TAGATCGGATC -> AGATCGGATCT
AGATCGGATCT -> GATCGGATCTG
GATCGGATCTG -> ATCGGATCTGT
ATCGGATCTGT -> TCGGATCTGTT
TCGGATCTGTT -> CGGATCTGTTA
CGGATCTGTTA -> GGATCTGTTAC
GGATCTGTTAC -> GATCTGTTACA
GATCTGTTACA -> ATCTGTTACAC
ATCTGTTACAC -> TCTGTTACACA
TCTGTTACACA -> CTGTTACACAC
CTGTTACACAC -> TGTTACACACT
TGTTACACACT -> GTTACACACTG
GTTACACACTG -> TTACACACTGT
TTACACACTGT -> TACACACTGTA
TACACACTGTA -> ACACACTGTAA
ACACACTGTAA -> CACACTGTAAC
CACACTGTAAC -> ACACTGTAACT
ACACTGTAACT -> CACTGTAACTG
CACTGTAACTG -> ACTGTAACTGA
ACTGTAACTGA -> CTGTAACTGAC
CTGTAACTGAC -> TGTAACTGACA
TGTAACTGACA -> GTAACTGACAC
GTAACTGACAC -> TAACTGACACT
TAACTGACACT -> AACTGACACTA
AACTGACACTA -> ACTGACACTAC
ACTGACACTAC -> CTGACACTACC
CTGACACTACC -> TGACACTACCC
TGACACTACCC -> GACACTACCCG
GACACTACCCG -> ACACTACCCGG
ACACTACCCGG -> CACTACCCGGT
CACTACCCGGT -> ACTACCCGGTA
ACTACCCGGTA -> CTACCCGGTAG
CTACCCGGTAG -> TACCCGGTAGA
TACCCGGTAGA -> ACCCGGTAGAG
ACCCGGTAGAG -> CCCGGTAGAGG
CCCGGTAGAGG -> CCGGTAGAGGT
CCGGTAGAGGT -> CGGTAGAGGTC
CGGTAGAGGTC -> GGTAGAGGTCG
GGTAGAGGTCG -> GTAGAGGTCGT
GTAGAGGTCGT -> TAGAGGTCGTG
TAGAGGTCGTG -> AGAGGTCGTGC
AGAGGTCGTGC -> GAGGTCGTGCC
GAGGTCGTGCC -> AGGTCGTGCCA
AGGTCGTGCCA -> GGTCGTGCCAA
GGTCGTGCCAA -> GTCGTGCCAAC
GTCGTGCCAAC -> TCGTGCCAACC
TCGTGCCAACC -> CGTGCCAACCC
CGTGCCAACCC -> GTGCCAACCCG
GTGCCAACCCG -> TGCCAACCCGG
TGCCAACCCGG -> GCCAACCCGGT
GCCAACCCGGT -> CCAACCCGGTG
CCAACCCGGTG -> CAACCCGGTGG
CAACCCGGTGG -> AACCCGGTGGG
AACCCGGTGGG -> ACCCGGTGGGT
ACCCGGTGGGT -> CCCGGTGGGTC
CCCGGTGGGTC -> CCGGTGGGTCC
CCGGTGGGTCC -> CGGTGGGTCCC
CGGTGGGTCCC -> GGTGGGTCCCG
GGTGGGTCCCG -> GTGGGTCCCGG
GTGGGTCCCGG -> TGGGTCCCGGG
TGGGTCCCGGG -> GGGTCCCGGGA
GGGTCCCGGGA -> GGTCCCGGGAG
GGTCCCGGGAG -> GTCCCGGGAGC
GTCCCGGGAGC -> TCCCGGGAGCC
TCCCGGGAGCC -> CCCGGGAGCCA
CCCGGGAGCCA -> CCGGGAGCCAC
CCGGGAGCCAC -> CGGGAGCCACC
CGGGAGCCACC -> GGGAGCCACCC
GGGAGCCACCC -> GGAGCCACCCC
GGAGCCACCCC -> GAGCCACCCCA
GAGCCACCCCA -> AGCCACCCCAG
AGCCACCCCAG -> GCCACCCCAGA
GCCACCCCAGA -> CCACCCCAGAC
CCACCCCAGAC -> CACCCCAGACT
CACCCCAGACT -> ACCCCAGACTC
ACCCCAGACTC -> CCCCAGACTCG
CCCCAGACTCG -> CCCAGACTCGT
CCCAGACTCGT -> CCAGACTCGTT
CCAGACTCGTT -> CAGACTCGTTA
CAGACTCGTTA -> AGACTCGTTAT
AGACTCGTTAT -> GACTCGTTATG
GACTCGTTATG -> ACTCGTTATGG
ACTCGTTATGG -> CTCGTTATGGT
CTCGTTATGGT -> TCGTTATGGTG
TCGTTATGGTG -> CGTTATGGTGA
CGTTATGGTGA -> GTTATGGTGAG
GTTATGGTGAG -> TTATGGTGAGG
TTATGGTGAGG -> TATGGTGAGGG
TATGGTGAGGG -> ATGGTGAGGGG
ATGGTGAGGGG -> TGGTGAGGGGA
TGGTGAGGGGA -> GGTGAGGGGAG
GGTGAGGGGAG -> GTGAGGGGAGA
GTGAGGGGAGA -> TGAGGGGAGAC
TGAGGGGAGAC -> GAGGGGAGACC
GAGGGGAGACC -> AGGGGAGACCT
AGGGGAGACCT -> GGGGAGACCTC
GGGGAGACCTC -> GGGAGACCTCT
GGGAGACCTCT -> GGAGACCTCTT
GGAGACCTCTT -> GAGACCTCTTC
GAGACCTCTTC -> AGACCTCTTCG
AGACCTCTTCG -> GACCTCTTCGG
GACCTCTTCGG -> ACCTCTTCGGT
ACCTCTTCGGT -> CCTCTTCGGTA
CCTCTTCGGTA -> CTCTTCGGTAG
CTCTTCGGTAG -> TCTTCGGTAGA
TCTTCGGTAGA -> CTTCGGTAGAG
CTTCGGTAGAG -> TTCGGTAGAGG
TTCGGTAGAGG -> TCGGTAGAGGG
TCGGTAGAGGG -> CGGTAGAGGGA
CGGTAGAGGGA -> GGTAGAGGGAA
GGTAGAGGGAA -> GTAGAGGGAAC
GTAGAGGGAAC -> TAGAGGGAACT
TAGAGGGAACT -> AGAGGGAACTG
AGAGGGAACTG -> GAGGGAACTGG
GAGGGAACTGG -> AGGGAACTGGA
AGGGAACTGGA -> GGGAACTGGAG
GGGAACTGGAG -> GGAACTGGAGA
GGAACTGGAGA -> GAACTGGAGAT
GAACTGGAGAT -> AACTGGAGATC
AACTGGAGATC -> ACTGGAGATCC
ACTGGAGATCC -> CTGGAGATCCG
CTGGAGATCCG -> TGGAGATCCGC
TGGAGATCCGC -> GGAGATCCGCG
GGAGATCCGCG -> GAGATCCGCGT
GAGATCCGCGT -> AGATCCGCGTT
AGATCCGCGTT -> GATCCGCGTTT
GATCCGCGTTT -> ATCCGCGTTTA
ATCCGCGTTTA -> TCCGCGTTTAT
TCCGCGTTTAT -> CCGCGTTTATC
CCGCGTTTATC -> CGCGTTTATCG
CGCGTTTATCG -> GCGTTTATCGT
GCGTTTATCGT -> CGTTTATCGTA
CGTTTATCGTA -> GTTTATCGTAA
GTTTATCGTAA -> TTTATCGTAAT
TTTATCGTAAT -> TTATCGTAATC
TTATCGTAATC -> TATCGTAATCT
TATCGTAATCT -> ATCGTAATCTG
ATCGTAATCTG -> TCGTAATCTGC
TCGTAATCTGC -> CGTAATCTGCG
CGTAATCTGCG -> GTAATCTGCGT
GTAATCTGCGT -> TAATCTGCGTT
TAATCTGCGTT -> AATCTGCGTTT
AATCTGCGTTT -> ATCTGCGTTTA
ATCTGCGTTTA -> TCTGCGTTTAA
TCTGCGTTTAA -> CTGCGTTTAAA
CTGCGTTTAAA -> TGCGTTTAAAC
TGCGTTTAAAC -> GCGTTTAAACA
GCGTTTAAACA -> CGTTTAAACAT
CGTTTAAACAT -> GTTTAAACATA
GTTTAAACATA -> TTTAAACATAA
TTTAAACATAA -> TTAAACATAAA
TTAAACATAAA -> TAAACATAAAA
TAAACATAAAA -> AAACATAAAAT
AAACATAAAAT -> AACATAAAATC
AACATAAAATC -> ACATAAAATCC
ACATAAAATCC -> CATAAAATCCT
CATAAAATCCT -> ATAAAATCCTA
ATAAAATCCTA -> TAAAATCCTAG
TAAAATCCTAG -> AAAATCCTAGA
AAAATCCTAGA -> AAATCCTAGAA
AAATCCTAGAA -> AATCCTAGAAA
AATCCTAGAAA -> ATCCTAGAAAG
ATCCTAGAAAG -> TCCTAGAAAGG
TCCTAGAAAGG -> CCTAGAAAGGA
CCTAGAAAGGA -> CTAGAAAGGAC
CTAGAAAGGAC -> TAGAAAGGACG
TAGAAAGGACG -> AGAAAGGACGG
AGAAAGGACGG -> GAAAGGACGGC
GAAAGGACGGC -> AAAGGACGGCT
AAAGGACGGCT -> AAGGACGGCTG
AAGGACGGCTG -> AGGACGGCTGA
AGGACGGCTGA -> GGACGGCTGAC
GGACGGCTGAC -> GACGGCTGACC
GACGGCTGACC -> ACGGCTGACCA
ACGGCTGACCA -> CGGCTGACCAC
CGGCTGACCAC -> GGCTGACCACG
GGCTGACCACG -> GCTGACCACGT
GCTGACCACGT -> CTGACCACGTA
CTGACCACGTA -> TGACCACGTAA
TGACCACGTAA -> GACCACGTAAG
GACCACGTAAG -> ACCACGTAAGG
ACCACGTAAGG -> CCACGTAAGGG
CCACGTAAGGG -> CACGTAAGGGG
CACGTAAGGGG -> ACGTAAGGGGG
ACGTAAGGGGG -> CGTAAGGGGGC
CGTAAGGGGGC -> GTAAGGGGGCC
GTAAGGGGGCC -> TAAGGGGGCCA
TAAGGGGGCCA -> AAGGGGGCCAA
AAGGGGGCCAA -> AGGGGGCCAAT
AGGGGGCCAAT -> GGGGGCCAATT
GGGGGCCAATT -> GGGGCCAATTA
GGGGCCAATTA -> GGGCCAATTAC
GGGCCAATTAC -> GGCCAATTACC
GGCCAATTACC -> GCCAATTACCA
GCCAATTACCA -> CCAATTACCAG
CCAATTACCAG -> CAATTACCAGG
CAATTACCAGG -> AATTACCAGGA
AATTACCAGGA -> ATTACCAGGAC
ATTACCAGGAC -> TTACCAGGACA
TTACCAGGACA -> TACCAGGACAC
TACCAGGACAC -> ACCAGGACACA
ACCAGGACACA -> CCAGGACACAT
CCAGGACACAT -> CAGGACACATC
CAGGACACATC -> AGGACACATCG
AGGACACATCG -> GGACACATCGG
GGACACATCGG -> GACACATCGGT
GACACATCGGT -> ACACATCGGTT
ACACATCGGTT -> CACATCGGTTT
CACATCGGTTT -> ACATCGGTTTA
ACATCGGTTTA -> CATCGGTTTAT
CATCGGTTTAT -> ATCGGTTTATA
ATCGGTTTATA -> TCGGTTTATAA
TCGGTTTATAA -> CGGTTTATAAG
CGGTTTATAAG -> GGTTTATAAGT
GGTTTATAAGT -> GTTTATAAGTA
GTTTATAAGTA -> TTTATAAGTAC
TTTATAAGTAC -> TTATAAGTACA
TTATAAGTACA -> TATAAGTACAT
TATAAGTACAT -> ATAAGTACATG
ATAAGTACATG -> TAAGTACATGT
TAAGTACATGT -> AAGTACATGTG
AAGTACATGTG -> AGTACATGTGA
AGTACATGTGA -> GTACATGTGAA
GTACATGTGAA -> TACATGTGAAT
TACATGTGAAT -> ACATGTGAATC
ACATGTGAATC -> CATGTGAATCT
CATGTGAATCT -> ATGTGAATCTA
ATGTGAATCTA -> TGTGAATCTAC
TGTGAATCTAC -> GTGAATCTACT
GTGAATCTACT -> TGAATCTACTA
TGAATCTACTA -> GAATCTACTAA
GAATCTACTAA -> AATCTACTAAG
AATCTACTAAG -> ATCTACTAAGG
ATCTACTAAGG -> TCTACTAAGGC
TCTACTAAGGC -> CTACTAAGGCG
CTACTAAGGCG -> TACTAAGGCGC
TACTAAGGCGC -> ACTAAGGCGCG
ACTAAGGCGCG -> CTAAGGCGCGA
CTAAGGCGCGA -> TAAGGCGCGAG
TAAGGCGCGAG -> AAGGCGCGAGA
AAGGCGCGAGA -> AGGCGCGAGAT
AGGCGCGAGAT -> GGCGCGAGATG
GGCGCGAGATG -> GCGCGAGATGC
GCGCGAGATGC -> CGCGAGATGCC
CGCGAGATGCC -> GCGAGATGCCG
GCGAGATGCCG -> CGAGATGCCGG
CGAGATGCCGG -> GAGATGCCGGC
GAGATGCCGGC -> AGATGCCGGCG
AGATGCCGGCG -> GATGCCGGCGG
GATGCCGGCGG -> ATGCCGGCGGG
ATGCCGGCGGG -> TGCCGGCGGGG
TGCCGGCGGGG -> GCCGGCGGGGC
GCCGGCGGGGC -> CCGGCGGGGCG
CCGGCGGGGCG -> CGGCGGGGCGC
CGGCGGGGCGC -> GGCGGGGCGCG
GGCGGGGCGCG -> GCGGGGCGCGG
GCGGGGCGCGG -> CGGGGCGCGGC
CGGGGCGCGGC -> GGGGCGCGGCC
GGGGCGCGGCC -> GGGCGCGGCCA
GGGCGCGGCCA -> GGCGCGGCCAA
GGCGCGGCCAA -> GCGCGGCCAAC
GCGCGGCCAAC -> CGCGGCCAACC
CGCGGCCAACC -> GCGGCCAACCT
GCGGCCAACCT -> CGGCCAACCTT
CGGCCAACCTT -> GGCCAACCTTG
GGCCAACCTTG -> GCCAACCTTGT
GCCAACCTTGT -> CCAACCTTGTG
CCAACCTTGTG -> CAACCTTGTGT
CAACCTTGTGT -> AACCTTGTGTG
AACCTTGTGTG -> ACCTTGTGTGT
ACCTTGTGTGT -> CCTTGTGTGTC
CCTTGTGTGTC -> CTTGTGTGTCT
CTTGTGTGTCT -> TTGTGTGTCTA
TTGTGTGTCTA -> TGTGTGTCTAT
TGTGTGTCTAT -> GTGTGTCTATA
GTGTGTCTATA -> TGTGTCTATAC
TGTGTCTATAC -> GTGTCTATACC
GTGTCTATACC -> TGTCTATACCA
TGTCTATACCA -> GTCTATACCAC
GTCTATACCAC -> TCTATACCACC
TCTATACCACC -> CTATACCACCT
CTATACCACCT -> TATACCACCTA
TATACCACCTA -> ATACCACCTAA
ATACCACCTAA -> TACCACCTAAT
TACCACCTAAT -> ACCACCTAATG
ACCACCTAATG -> CCACCTAATGG
CCACCTAATGG -> CACCTAATGGG
CACCTAATGGG -> ACCTAATGGGG
ACCTAATGGGG -> CCTAATGGGGA
CCTAATGGGGA -> CTAATGGGGAG
CTAATGGGGAG -> TAATGGGGAGG
TAATGGGGAGG -> AATGGGGAGGT
AATGGGGAGGT -> ATGGGGAGGTA
ATGGGGAGGTA -> TGGGGAGGTAT
TGGGGAGGTAT -> GGGGAGGTATG
GGGGAGGTATG -> GGGAGGTATGT
GGGAGGTATGT -> GGAGGTATGTG
GGAGGTATGTG -> GAGGTATGTGA
GAGGTATGTGA -> AGGTATGTGAT
AGGTATGTGAT -> GGTATGTGATG
GGTATGTGATG -> GTATGTGATGT
GTATGTGATGT -> TATGTGATGTG
TATGTGATGTG -> ATGTGATGTGG
ATGTGATGTGG -> TGTGATGTGGA
TGTGATGTGGA -> GTGATGTGGAA
GTGATGTGGAA -> TGATGTGGAAA
TGATGTGGAAA -> GATGTGGAAAC
GATGTGGAAAC -> ATGTGGAAACA
ATGTGGAAACA -> TGTGGAAACAA
TGTGGAAACAA -> GTGGAAACAAC
GTGGAAACAAC -> TGGAAACAACG
TGGAAACAACG -> GGAAACAACGC
GGAAACAACGC -> GAAACAACGCC
GAAACAACGCC -> AAACAACGCCT
AAACAACGCCT -> AACAACGCCTC
AACAACGCCTC -> ACAACGCCTCG
ACAACGCCTCG -> CAACGCCTCGC
CAACGCCTCGC -> AACGCCTCGCT
AACGCCTCGCT -> ACGCCTCGCTT
ACGCCTCGCTT -> CGCCTCGCTTA
CGCCTCGCTTA -> GCCTCGCTTAC
GCCTCGCTTAC -> CCTCGCTTACT
CCTCGCTTACT -> CTCGCTTACTT
CTCGCTTACTT -> TCGCTTACTTG
TCGCTTACTTG -> CGCTTACTTGG
CGCTTACTTGG -> GCTTACTTGGA
GCTTACTTGGA -> CTTACTTGGAG
CTTACTTGGAG -> TTACTTGGAGC
TTACTTGGAGC -> TACTTGGAGCC
TACTTGGAGCC -> ACTTGGAGCCT
ACTTGGAGCCT -> CTTGGAGCCTA
CTTGGAGCCTA -> TTGGAGCCTAT
TTGGAGCCTAT -> TGGAGCCTATT
TGGAGCCTATT -> GGAGCCTATTA
GGAGCCTATTA -> GAGCCTATTAC
GAGCCTATTAC -> AGCCTATTACG
AGCCTATTACG -> GCCTATTACGG
GCCTATTACGG -> CCTATTACGGG
CCTATTACGGG -> CTATTACGGGA
CTATTACGGGA -> TATTACGGGAC